Entity,Year,Terrorism Fatalities (GTD),"Number of terrorist incidents (GDT, 2018)","Number of successful terrorist incidents (GDT, 2018)","Number of unsuccessful terrorist incidents (GDT, 2018)","Share of terrorist incidents successful (GDT, 2018)","Number of suicide terrorist incidents (GDT, 2018)","Number of non-suicide terrorist incidents (GDT, 2018)","Share of terrorist incidents with suicide attempt (GDT, 2018)","Number wounded from terrorist attacks (GDT, 2018)","Number of incidents which resulted in fatality (GDT, 2018)","Share of terrorist incidents with at least one fatality (GDT, 2018)","Average fatalities per incident (GDT, 2018)"
Afghanistan,1973,0,1,0,1,0,0,1,0,1,0,0,0
Afghanistan,1979,53,3,3,0,100,0,3,0,1,3,100,17.66666667
Afghanistan,1987,0,1,1,0,100,0,1,0,2,0,0,0
Afghanistan,1988,128,11,11,0,100,0,11,0,106,10,90.90909091,11.63636364
Afghanistan,1989,10,10,6,4,60,0,10,0,84,2,20,1
Afghanistan,1990,12,2,2,0,100,0,2,0,122,2,100,6
Afghanistan,1991,68,30,30,0,100,0,30,0,127,11,36.66666667,2.266666667
Afghanistan,1992,49,36,29,7,80.55555556,0,36,0,185,13,36.11111111,1.361111111
Afghanistan,1994,22,9,9,0,100,0,9,0,30,3,33.33333333,2.444444444
Afghanistan,1995,5,6,5,1,83.33333333,0,6,0,10,2,33.33333333,0.833333333
Afghanistan,1996,31,4,3,1,75,0,4,0,30,2,50,7.75
Afghanistan,1997,4,1,1,0,100,0,1,0,37,1,100,4
Afghanistan,1998,8,1,1,0,100,0,1,0,30,1,100,8
Afghanistan,1999,39,9,9,0,100,0,9,0,41,6,66.66666667,4.333333333
Afghanistan,2000,38,14,14,0,100,0,14,0,11,3,21.42857143,2.714285714
Afghanistan,2001,174,14,14,0,100,1,13,7.142857143,59,6,42.85714286,12.42857143
Afghanistan,2002,74,38,28,10,73.68421053,2,36,5.263157895,297,10,26.31578947,1.947368421
Afghanistan,2003,163,100,93,7,93,1,99,1,186,36,36,1.63
Afghanistan,2004,275,88,79,9,89.77272727,3,85,3.409090909,263,62,70.45454545,3.125
Afghanistan,2005,367,155,150,5,96.77419355,13,142,8.387096774,411,111,71.61290323,2.367741935
Afghanistan,2006,732,282,273,9,96.80851064,52,230,18.43971631,922,195,69.14893617,2.595744681
Afghanistan,2007,1199,341,336,5,98.53372434,76,265,22.28739003,1152,270,79.17888563,3.516129032
Afghanistan,2008,1092,414,385,29,92.99516908,57,357,13.76811594,1331,271,65.4589372,2.637681159
Afghanistan,2009,1065,503,477,26,94.83101392,45,458,8.946322068,1604,309,61.43141153,2.117296223
Afghanistan,2010,1157,542,497,45,91.69741697,52,490,9.594095941,1701,298,54.98154982,2.134686347
Afghanistan,2011,1525,421,397,24,94.29928741,80,341,19.0023753,1941,308,73.15914489,3.622327791
Afghanistan,2012,3521,1469,1344,125,91.49081007,136,1333,9.257998639,4661,1059,72.08985705,2.396868618
Afghanistan,2013,3709,1443,1333,110,92.37699238,130,1313,9.009009009,4322,1046,72.48787249,2.57033957
Afghanistan,2014,5414,1824,1665,159,91.28289474,187,1637,10.25219298,5111,1315,72.09429825,2.968201754
Afghanistan,2015,6216,1928,1627,301,84.3879668,151,1777,7.831950207,6987,1274,66.07883817,3.22406639
Afghanistan,2016,6142,1617,1210,407,74.82993197,111,1506,6.864564007,6485,1070,66.17192331,3.798392084
Afghanistan,2017,6092,1414,1109,305,78.42998586,131,1283,9.264497878,6027,1007,71.21640736,4.30834512
Albania,1981,0,1,1,0,100,0,1,0,0,0,0,0
Albania,1990,0,1,1,0,100,0,1,0,0,0,0,0
Albania,1991,0,1,1,0,100,0,1,0,0,0,0,0
Albania,1992,1,3,2,1,66.66666667,0,3,0,0,1,33.33333333,0.333333333
Albania,1994,1,2,2,0,100,0,2,0,0,1,50,0.5
Albania,1996,7,6,4,2,66.66666667,0,6,0,37,3,50,1.166666667
Albania,1997,26,41,35,6,85.36585366,0,41,0,77,12,29.26829268,0.634146341
Albania,1998,0,7,7,0,100,0,7,0,5,0,0,0
Albania,1999,6,3,3,0,100,0,3,0,5,2,66.66666667,2
Albania,2000,0,2,1,1,50,0,2,0,0,0,0,0
Albania,2001,0,1,1,0,100,0,1,0,0,0,0,0
Albania,2003,0,1,0,1,0,0,1,0,0,0,0,0
Albania,2009,0,1,1,0,100,0,1,0,0,0,0,0
Albania,2013,0,1,0,1,0,0,1,0,0,0,0,0
Albania,2014,1,2,2,0,100,0,2,0,2,1,50,0.5
Albania,2015,0,4,1,3,25,0,4,0,0,0,0,0
Albania,2016,0,2,1,1,50,0,2,0,0,0,0,0
Albania,2017,0,1,1,0,100,0,1,0,0,0,0,0
Algeria,1972,0,1,1,0,100,0,1,0,0,0,0,0
Algeria,1976,0,1,1,0,100,0,1,0,0,0,0,0
Algeria,1978,0,1,0,1,0,0,1,0,1,0,0,0
Algeria,1979,0,1,1,0,100,0,1,0,0,0,0,0
Algeria,1990,3,2,1,1,50,0,2,0,1,1,50,1.5
Algeria,1991,42,30,29,1,96.66666667,0,30,0,73,11,36.66666667,1.4
Algeria,1992,236,215,181,34,84.18604651,0,215,0,274,120,55.81395349,1.097674419
Algeria,1994,500,227,215,12,94.71365639,0,227,0,133,180,79.29515419,2.202643172
Algeria,1995,418,185,170,15,91.89189189,2,183,1.081081081,1061,147,79.45945946,2.259459459
Algeria,1996,529,129,127,2,98.4496124,0,129,0,1118,99,76.74418605,4.100775194
Algeria,1997,4266,344,338,6,98.25581395,0,344,0,1861,310,90.11627907,12.40116279
Algeria,1998,952,151,147,4,97.35099338,0,151,0,949,108,71.52317881,6.304635762
Algeria,1999,467,106,105,1,99.05660377,0,106,0,325,93,87.73584906,4.405660377
Algeria,2000,528,138,136,2,98.55072464,0,138,0,275,120,86.95652174,3.826086957
Algeria,2001,624,113,110,3,97.34513274,0,113,0,253,103,91.15044248,5.522123894
Algeria,2002,615,132,128,4,96.96969697,0,132,0,320,101,76.51515152,4.659090909
Algeria,2003,269,75,71,4,94.66666667,0,75,0,112,65,86.66666667,3.586666667
Algeria,2004,166,67,65,2,97.01492537,0,67,0,187,51,76.11940299,2.47761194
Algeria,2005,228,104,95,9,91.34615385,0,104,0,228,75,72.11538462,2.192307692
Algeria,2006,185,152,139,13,91.44736842,0,152,0,266,71,46.71052632,1.217105263
Algeria,2007,241,124,102,22,82.25806452,5,119,4.032258065,697,51,41.12903226,1.943548387
Algeria,2008,249,107,95,12,88.78504673,11,96,10.28037383,328,72,67.28971963,2.327102804
Algeria,2009,204,108,102,6,94.44444444,3,105,2.777777778,211,58,53.7037037,1.888888889
Algeria,2010,109,100,94,6,94,3,97,3,220,43,43,1.09
Algeria,2011,25,15,10,5,66.66666667,1,14,6.666666667,34,6,40,1.666666667
Algeria,2012,30,41,39,2,95.12195122,2,39,4.87804878,105,18,43.90243902,0.731707317
Algeria,2013,101,22,21,1,95.45454545,1,21,4.545454545,48,15,68.18181818,4.590909091
Algeria,2014,37,13,12,1,92.30769231,1,12,7.692307692,30,11,84.61538462,2.846153846
Algeria,2015,21,16,13,3,81.25,0,16,0,19,8,50,1.3125
Algeria,2016,9,9,6,3,66.66666667,1,8,11.11111111,2,4,44.44444444,1
Algeria,2017,12,14,7,7,50,3,11,21.42857143,19,6,42.85714286,0.857142857
Andorra,1974,0,1,1,0,100,0,1,0,0,0,0,0
Angola,1977,0,1,1,0,100,0,1,0,0,0,0,0
Angola,1978,0,2,2,0,100,0,2,0,40,0,0,0
Angola,1979,19,3,3,0,100,0,3,0,30,2,66.66666667,6.333333333
Angola,1981,3,1,1,0,100,0,1,0,0,1,100,3
Angola,1982,2,2,2,0,100,0,2,0,0,1,50,1
Angola,1983,282,7,7,0,100,0,7,0,349,6,85.71428571,40.28571429
Angola,1984,179,11,11,0,100,0,11,0,70,6,54.54545455,16.27272727
Angola,1985,6,6,6,0,100,0,6,0,0,2,33.33333333,1
Angola,1986,119,5,5,0,100,0,5,0,23,4,80,23.8
Angola,1987,5,3,3,0,100,0,3,0,10,2,66.66666667,1.666666667
Angola,1988,145,12,12,0,100,0,12,0,138,8,66.66666667,12.08333333
Angola,1989,88,12,12,0,100,0,12,0,10,7,58.33333333,7.333333333
Angola,1990,147,205,201,4,98.04878049,0,205,0,217,14,6.829268293,0.717073171
Angola,1991,69,16,14,2,87.5,0,16,0,75,5,31.25,4.3125
Angola,1992,97,50,47,3,94,0,50,0,56,28,56,1.94
Angola,1994,108,9,9,0,100,0,9,0,75,7,77.77777778,12
Angola,1995,52,10,9,1,90,0,10,0,26,7,70,5.2
Angola,1996,18,4,4,0,100,0,4,0,6,4,100,4.5
Angola,1997,34,7,7,0,100,0,7,0,32,6,85.71428571,4.857142857
Angola,1998,275,20,20,0,100,0,20,0,47,17,85,13.75
Angola,1999,299,34,33,1,97.05882353,0,34,0,299,23,67.64705882,8.794117647
Angola,2000,178,22,22,0,100,0,22,0,43,17,77.27272727,8.090909091
Angola,2001,846,40,39,1,97.5,0,40,0,474,33,82.5,21.15
Angola,2002,59,6,6,0,100,0,6,0,17,6,100,9.833333333
Angola,2009,2,1,1,0,100,0,1,0,0,1,100,2
Angola,2010,4,2,2,0,100,0,2,0,7,2,100,2
Angola,2016,0,2,1,1,50,0,2,0,0,0,0,0
Angola,2017,7,6,6,0,100,0,6,0,411,3,50,1.166666667
Antigua and Barbuda,1992,0,1,1,0,100,0,1,0,0,0,0,0
Argentina,1970,5,21,21,0,100,0,21,0,2,5,23.80952381,0.238095238
Argentina,1971,5,7,7,0,100,0,7,0,0,3,42.85714286,0.714285714
Argentina,1972,5,20,14,6,70,0,20,0,0,5,25,0.25
Argentina,1973,16,60,56,4,93.33333333,0,60,0,4,16,26.66666667,0.266666667
Argentina,1974,21,71,69,2,97.18309859,0,71,0,12,15,21.12676056,0.295774648
Argentina,1975,123,38,36,2,94.73684211,0,38,0,16,6,15.78947368,3.236842105
Argentina,1976,122,54,49,5,90.74074074,0,54,0,90,25,46.2962963,2.259259259
Argentina,1977,7,17,16,1,94.11764706,0,17,0,12,6,35.29411765,0.411764706
Argentina,1978,13,25,22,3,88,0,25,0,11,9,36,0.52
Argentina,1979,11,16,12,4,75,0,16,0,12,5,31.25,0.6875
Argentina,1980,0,6,4,2,66.66666667,0,6,0,1,0,0,0
Argentina,1981,0,2,2,0,100,0,2,0,0,0,0,0
Argentina,1982,1,9,9,0,100,0,9,0,0,1,11.11111111,0.111111111
Argentina,1983,1,18,12,6,66.66666667,0,18,0,3,1,5.555555556,0.055555556
Argentina,1984,1,46,38,8,82.60869565,0,46,0,4,1,2.173913043,0.02173913
Argentina,1985,2,43,39,4,90.69767442,0,43,0,10,2,4.651162791,0.046511628
Argentina,1986,2,33,31,2,93.93939394,0,33,0,12,2,6.060606061,0.060606061
Argentina,1987,3,80,72,8,90,0,80,0,11,3,3.75,0.0375
Argentina,1988,1,33,28,5,84.84848485,0,33,0,20,1,3.03030303,0.03030303
Argentina,1989,26,32,27,5,84.375,0,32,0,17,2,6.25,0.8125
Argentina,1990,1,31,26,5,83.87096774,0,31,0,1,1,3.225806452,0.032258065
Argentina,1991,1,27,21,6,77.77777778,0,27,0,7,1,3.703703704,0.037037037
Argentina,1992,33,41,38,3,92.68292683,1,40,2.43902439,224,3,7.317073171,0.804878049
Argentina,1994,86,14,12,2,85.71428571,1,13,7.142857143,266,2,14.28571429,6.142857143
Argentina,1995,0,16,11,5,68.75,0,16,0,1,0,0,0
Argentina,1996,1,19,10,9,52.63157895,0,19,0,12,1,5.263157895,0.052631579
Argentina,1997,3,11,10,1,90.90909091,0,11,0,2,3,27.27272727,0.272727273
Argentina,1999,0,1,1,0,100,0,1,0,0,0,0,0
Argentina,2001,0,2,2,0,100,0,2,0,1,0,0,0
Argentina,2003,0,1,1,0,100,0,1,0,0,0,0,0
Argentina,2005,0,3,2,1,66.66666667,0,3,0,0,0,0,0
Argentina,2009,0,1,1,0,100,0,1,0,0,0,0,0
Argentina,2010,0,5,5,0,100,0,5,0,0,0,0,0
Argentina,2011,0,1,1,0,100,0,1,0,0,0,0,0
Argentina,2012,0,2,1,1,50,0,2,0,0,0,0,0
Argentina,2013,0,2,2,0,100,0,2,0,2,0,0,0
Argentina,2014,0,1,1,0,100,0,1,0,0,0,0,0
Argentina,2015,0,1,0,1,0,0,1,0,0,0,0,0
Argentina,2016,0,2,2,0,100,0,2,0,2,0,0,0
Argentina,2017,0,3,3,0,100,0,3,0,0,0,0,0
Armenia,1991,0,1,1,0,100,0,1,0,0,0,0,0
Armenia,1992,2,2,2,0,100,0,2,0,1,1,50,1
Armenia,1994,15,4,4,0,100,0,4,0,46,2,50,3.75
Armenia,1995,2,1,1,0,100,0,1,0,20,1,100,2
Armenia,1996,2,1,1,0,100,0,1,0,0,1,100,2
Armenia,1998,0,2,1,1,50,0,2,0,1,0,0,0
Armenia,1999,8,2,2,0,100,0,2,0,0,1,50,4
Armenia,2000,0,2,2,0,100,0,2,0,0,0,0,0
Armenia,2001,1,2,1,1,50,0,2,0,0,1,50,0.5
Armenia,2007,0,1,1,0,100,0,1,0,0,0,0,0
Armenia,2009,1,1,1,0,100,0,1,0,0,1,100,1
Armenia,2013,0,1,0,1,0,0,1,0,1,0,0,0
Armenia,2015,0,2,1,1,50,0,2,0,1,0,0,0
Armenia,2016,6,2,2,0,100,0,2,0,1,1,50,3
Australasia & Oceania,1970,0,1,1,0,100,0,1,0,0,0,0,0
Australasia & Oceania,1971,0,1,1,0,100,0,1,0,0,0,0,0
Australasia & Oceania,1972,1,8,2,6,25,0,8,0,0,1,12.5,0.125
Australasia & Oceania,1973,0,1,1,0,100,0,1,0,0,0,0,0
Australasia & Oceania,1974,0,1,1,0,100,0,1,0,0,0,0,0
Australasia & Oceania,1975,0,0,0,0,0,0,0,0,0,0,,
Australasia & Oceania,1976,0,0,0,0,0,0,0,0,0,0,,
Australasia & Oceania,1977,0,0,0,0,0,0,0,0,0,0,,
Australasia & Oceania,1978,2,2,2,0,100,0,2,0,9,1,50,1
Australasia & Oceania,1979,0,2,2,0,100,0,2,0,9,0,0,0
Australasia & Oceania,1980,2,7,6,1,85.71428571,0,7,0,3,1,14.28571429,0.285714286
Australasia & Oceania,1981,1,3,3,0,100,0,3,0,0,1,33.33333333,0.333333333
Australasia & Oceania,1982,0,2,2,0,100,0,2,0,3,0,0,0
Australasia & Oceania,1983,0,0,0,0,0,0,0,0,0,0,,
Australasia & Oceania,1984,12,11,11,0,100,0,11,0,1,3,27.27272727,1.090909091
Australasia & Oceania,1985,0,7,7,0,100,0,7,0,11,0,0,0
Australasia & Oceania,1986,1,4,4,0,100,0,4,0,22,1,25,0.25
Australasia & Oceania,1987,0,3,3,0,100,0,3,0,1,0,0,0
Australasia & Oceania,1988,22,12,8,4,66.66666667,0,12,0,11,3,25,1.833333333
Australasia & Oceania,1989,15,29,24,5,82.75862069,0,29,0,25,8,27.5862069,0.517241379
Australasia & Oceania,1990,12,18,17,1,94.44444444,0,18,0,12,5,27.77777778,0.666666667
Australasia & Oceania,1991,3,10,9,1,90,0,10,0,0,2,20,0.3
Australasia & Oceania,1992,9,17,15,2,88.23529412,0,17,0,14,4,23.52941176,0.529411765
Australasia & Oceania,1994,20,14,12,2,85.71428571,0,14,0,34,4,28.57142857,1.428571429
Australasia & Oceania,1995,6,18,16,2,88.88888889,0,18,0,17,3,16.66666667,0.333333333
Australasia & Oceania,1996,23,19,19,0,100,0,19,0,14,5,26.31578947,1.210526316
Australasia & Oceania,1997,0,7,6,1,85.71428571,0,7,0,23,0,0,0
Australasia & Oceania,1998,0,6,6,0,100,0,6,0,2,0,0,0
Australasia & Oceania,1999,2,4,4,0,100,0,4,0,0,1,25,0.5
Australasia & Oceania,2000,7,6,4,2,66.66666667,0,6,0,17,1,16.66666667,1.166666667
Australasia & Oceania,2001,0,4,2,2,50,0,4,0,0,0,0,0
Australasia & Oceania,2002,1,2,2,0,100,0,2,0,0,1,50,0.5
Australasia & Oceania,2003,1,4,1,3,25,0,4,0,0,1,25,0.25
Australasia & Oceania,2004,0,0,0,0,0,0,0,0,0,0,,
Australasia & Oceania,2005,0,0,0,0,0,0,0,0,0,0,,
Australasia & Oceania,2006,0,2,2,0,100,0,2,0,0,0,0,0
Australasia & Oceania,2007,0,1,1,0,100,0,1,0,0,0,0,0
Australasia & Oceania,2008,0,8,2,6,25,0,8,0,0,0,0,0
Australasia & Oceania,2009,0,1,1,0,100,0,1,0,0,0,0,0
Australasia & Oceania,2010,0,1,1,0,100,0,1,0,0,0,0,0
Australasia & Oceania,2011,0,0,0,0,0,0,0,0,0,0,,
Australasia & Oceania,2012,0,0,0,0,0,0,0,0,0,0,,
Australasia & Oceania,2013,0,1,1,0,100,0,1,0,0,0,0,0
Australasia & Oceania,2014,4,9,9,0,100,0,9,0,7,2,22.22222222,0.444444444
Australasia & Oceania,2015,2,14,13,1,92.85714286,0,14,0,0,1,7.142857143,0.142857143
Australasia & Oceania,2016,0,10,10,0,100,0,10,0,1,0,0,0
Australasia & Oceania,2017,4,12,9,3,75,1,11,8.333333333,24,3,25,0.333333333
Australia,1970,0,1,1,0,100,0,1,0,0,0,0,0
Australia,1971,0,1,1,0,100,0,1,0,0,0,0,0
Australia,1972,1,8,2,6,25,0,8,0,0,1,12.5,0.125
Australia,1974,0,1,1,0,100,0,1,0,0,0,0,0
Australia,1978,2,2,2,0,100,0,2,0,9,1,50,1
Australia,1979,0,2,2,0,100,0,2,0,9,0,0,0
Australia,1980,2,6,5,1,83.33333333,0,6,0,3,1,16.66666667,0.333333333
Australia,1981,1,1,1,0,100,0,1,0,0,1,100,1
Australia,1982,0,2,2,0,100,0,2,0,3,0,0,0
Australia,1986,1,2,2,0,100,0,2,0,22,1,50,0.5
Australia,1988,0,3,2,1,66.66666667,0,3,0,0,0,0,0
Australia,1989,0,2,1,1,50,0,2,0,0,0,0,0
Australia,1991,0,4,4,0,100,0,4,0,0,0,0,0
Australia,1992,1,4,3,1,75,0,4,0,4,1,25,0.25
Australia,1994,3,9,9,0,100,0,9,0,8,3,33.33333333,0.333333333
Australia,1995,0,5,4,1,80,0,5,0,0,0,0,0
Australia,1996,2,5,5,0,100,0,5,0,1,1,20,0.4
Australia,1997,0,4,3,1,75,0,4,0,23,0,0,0
Australia,1998,0,6,6,0,100,0,6,0,2,0,0,0
Australia,2000,0,1,0,1,0,0,1,0,0,0,0,0
Australia,2001,0,2,1,1,50,0,2,0,0,0,0,0
Australia,2006,0,2,2,0,100,0,2,0,0,0,0,0
Australia,2008,0,3,2,1,66.66666667,0,3,0,0,0,0,0
Australia,2009,0,1,1,0,100,0,1,0,0,0,0,0
Australia,2010,0,1,1,0,100,0,1,0,0,0,0,0
Australia,2013,0,1,1,0,100,0,1,0,0,0,0,0
Australia,2014,4,8,8,0,100,0,8,0,7,2,25,0.5
Australia,2015,2,14,13,1,92.85714286,0,14,0,0,1,7.142857143,0.142857143
Australia,2016,0,9,9,0,100,0,9,0,1,0,0,0
Australia,2017,4,4,3,1,75,1,3,25,21,3,75,1
Austria,1972,4,7,2,5,28.57142857,0,7,0,5,1,14.28571429,0.571428571
Austria,1973,0,2,1,1,50,0,2,0,0,0,0,0
Austria,1974,0,1,0,1,0,0,1,0,0,0,0,0
Austria,1975,4,2,2,0,100,0,2,0,11,2,100,2
Austria,1976,0,4,4,0,100,0,4,0,0,0,0,0
Austria,1977,1,5,3,2,60,0,5,0,1,1,20,0.2
Austria,1978,0,1,1,0,100,0,1,0,0,0,0,0
Austria,1979,0,5,4,1,80,0,5,0,6,0,0,0
Austria,1980,0,2,2,0,100,0,2,0,8,0,0,0
Austria,1981,3,3,3,0,100,0,3,0,20,2,66.66666667,1
Austria,1982,0,11,8,3,72.72727273,0,11,0,0,0,0,0
Austria,1984,2,4,4,0,100,0,4,0,1,2,50,0.5
Austria,1985,4,4,3,1,75,0,4,0,50,1,25,1
Austria,1986,0,4,2,2,50,0,4,0,0,0,0,0
Austria,1987,0,4,1,3,25,0,4,0,1,0,0,0
Austria,1988,0,1,1,0,100,0,1,0,1,0,0,0
Austria,1989,3,2,2,0,100,0,2,0,0,1,50,1.5
Austria,1990,0,1,1,0,100,0,1,0,0,0,0,0
Austria,1991,0,3,3,0,100,0,3,0,0,0,0,0
Austria,1992,0,8,7,1,87.5,0,8,0,1,0,0,0
Austria,1994,0,5,1,4,20,0,5,0,3,0,0,0
Austria,1995,6,12,10,2,83.33333333,0,12,0,6,2,16.66666667,0.5
Austria,1996,0,4,4,0,100,0,4,0,1,0,0,0
Austria,1997,0,1,1,0,100,0,1,0,0,0,0,0
Austria,1998,0,1,0,1,0,0,1,0,0,0,0,0
Austria,2006,0,1,1,0,100,0,1,0,0,0,0,0
Austria,2007,0,1,1,0,100,0,1,0,0,0,0,0
Austria,2008,0,7,7,0,100,0,7,0,0,0,0,0
Austria,2009,1,3,3,0,100,0,3,0,9,1,33.33333333,0.333333333
Austria,2011,0,1,1,0,100,0,1,0,0,0,0,0
Austria,2013,0,1,1,0,100,0,1,0,2,0,0,0
Austria,2016,0,3,3,0,100,0,3,0,0,0,0,0
Austria,2017,2,1,1,0,100,0,1,0,0,1,100,2
Azerbaijan,1991,26,3,3,0,100,0,3,0,4,2,66.66666667,8.666666667
Azerbaijan,1992,186,12,12,0,100,0,12,0,50,8,66.66666667,15.5
Azerbaijan,1994,30,11,10,1,90.90909091,0,11,0,104,6,54.54545455,2.727272727
Azerbaijan,1995,0,2,0,2,0,0,2,0,0,0,0,0
Azerbaijan,1996,2,2,2,0,100,0,2,0,0,2,100,1
Azerbaijan,1997,1,1,1,0,100,0,1,0,0,1,100,1
Azerbaijan,2000,0,1,0,1,0,0,1,0,3,0,0,0
Azerbaijan,2001,1,4,4,0,100,0,4,0,6,1,25,0.25
Azerbaijan,2002,0,1,1,0,100,0,1,0,1,0,0,0
Azerbaijan,2007,0,1,1,0,100,0,1,0,0,0,0,0
Azerbaijan,2008,5,2,2,0,100,0,2,0,13,2,100,2.5
Azerbaijan,2009,1,2,2,0,100,0,2,0,2,1,50,0.5
Azerbaijan,2014,0,3,3,0,100,0,3,0,1,0,0,0
Azerbaijan,2016,1,2,1,1,50,1,1,50,1,1,50,0.5
Azerbaijan,2017,5,2,2,0,100,0,2,0,2,1,50,2.5
Bahamas,1976,0,1,1,0,100,0,1,0,0,0,0,0
Bahamas,1981,0,1,1,0,100,0,1,0,0,0,0,0
Bahamas,1997,1,2,2,0,100,0,2,0,0,1,50,0.5
Bahamas,2013,0,1,0,1,0,0,1,0,0,0,0,0
Bahrain,1979,0,1,1,0,100,0,1,0,0,0,0,0
Bahrain,1980,0,1,1,0,100,0,1,0,0,0,0,0
Bahrain,1991,1,1,1,0,100,0,1,0,0,1,100,1
Bahrain,1994,0,1,1,0,100,0,1,0,3,0,0,0
Bahrain,1995,1,8,8,0,100,0,8,0,2,1,12.5,0.125
Bahrain,1996,8,16,15,1,93.75,0,16,0,15,2,12.5,0.5
Bahrain,1997,5,11,10,1,90.90909091,0,11,0,2,2,18.18181818,0.454545455
Bahrain,2003,0,1,1,0,100,0,1,0,0,0,0,0
Bahrain,2006,0,1,1,0,100,0,1,0,0,0,0,0
Bahrain,2008,1,1,1,0,100,0,1,0,2,1,100,1
Bahrain,2010,0,2,1,1,50,0,2,0,0,0,0,0
Bahrain,2011,0,1,1,0,100,0,1,0,0,0,0,0
Bahrain,2012,4,26,22,4,84.61538462,0,26,0,37,4,15.38461538,0.153846154
Bahrain,2013,3,52,41,11,78.84615385,0,52,0,39,3,5.769230769,0.057692308
Bahrain,2014,9,42,35,7,83.33333333,0,42,0,39,6,14.28571429,0.214285714
Bahrain,2015,5,18,16,2,88.88888889,0,18,0,22,4,22.22222222,0.277777778
Bahrain,2016,1,3,2,1,66.66666667,0,3,0,2,1,33.33333333,0.333333333
Bahrain,2017,6,21,21,0,100,0,21,0,26,6,28.57142857,0.285714286
Bangladesh,1977,0,1,1,0,100,0,1,0,1,0,0,0
Bangladesh,1979,0,1,1,0,100,0,1,0,0,0,0,0
Bangladesh,1980,6,1,0,1,0,0,1,0,80,1,100,6
Bangladesh,1981,6,1,1,0,100,0,1,0,2,1,100,6
Bangladesh,1982,0,1,1,0,100,0,1,0,4,0,0,0
Bangladesh,1984,1,1,1,0,100,0,1,0,0,1,100,1
Bangladesh,1985,0,1,1,0,100,0,1,0,13,0,0,0
Bangladesh,1986,54,11,11,0,100,0,11,0,263,6,54.54545455,4.909090909
Bangladesh,1987,26,6,5,1,83.33333333,0,6,0,2,4,66.66666667,4.333333333
Bangladesh,1988,87,36,36,0,100,0,36,0,166,17,47.22222222,2.416666667
Bangladesh,1989,131,36,35,1,97.22222222,0,36,0,196,26,72.22222222,3.638888889
Bangladesh,1990,66,22,22,0,100,0,22,0,132,16,72.72727273,3
Bangladesh,1991,69,42,40,2,95.23809524,0,42,0,454,20,47.61904762,1.642857143
Bangladesh,1992,101,76,73,3,96.05263158,0,76,0,491,35,46.05263158,1.328947368
Bangladesh,1994,30,68,66,2,97.05882353,0,68,0,657,10,14.70588235,0.441176471
Bangladesh,1995,35,74,67,7,90.54054054,0,74,0,892,23,31.08108108,0.472972973
Bangladesh,1996,89,161,154,7,95.65217391,0,161,0,1463,48,29.8136646,0.552795031
Bangladesh,1997,14,17,17,0,100,0,17,0,349,8,47.05882353,0.823529412
Bangladesh,1998,0,2,2,0,100,0,2,0,1,0,0,0
Bangladesh,1999,30,11,7,4,63.63636364,0,11,0,185,6,54.54545455,2.727272727
Bangladesh,2000,11,23,22,1,95.65217391,0,23,0,34,4,17.39130435,0.47826087
Bangladesh,2001,57,15,15,0,100,1,14,6.666666667,258,10,66.66666667,3.8
Bangladesh,2002,21,5,5,0,100,0,5,0,440,4,80,4.2
Bangladesh,2003,3,4,4,0,100,0,4,0,13,2,50,0.75
Bangladesh,2004,43,11,11,0,100,0,11,0,384,8,72.72727273,3.909090909
Bangladesh,2005,44,23,22,1,95.65217391,6,17,26.08695652,404,18,78.26086957,1.913043478
Bangladesh,2006,19,23,23,0,100,0,23,0,57,4,17.39130435,0.826086957
Bangladesh,2007,1,9,7,2,77.77777778,0,9,0,10,1,11.11111111,0.111111111
Bangladesh,2008,9,19,17,2,89.47368421,0,19,0,48,8,42.10526316,0.473684211
Bangladesh,2009,18,27,24,3,88.88888889,0,27,0,46,15,55.55555556,0.666666667
Bangladesh,2010,15,22,20,2,90.90909091,1,21,4.545454545,28,11,50,0.681818182
Bangladesh,2011,9,13,12,1,92.30769231,0,13,0,6,8,61.53846154,0.692307692
Bangladesh,2012,8,18,15,3,83.33333333,0,18,0,32,6,33.33333333,0.444444444
Bangladesh,2013,16,139,121,18,87.05035971,0,139,0,117,8,5.755395683,0.115107914
Bangladesh,2014,38,130,125,5,96.15384615,0,130,0,114,23,17.69230769,0.292307692
Bangladesh,2015,86,469,413,56,88.05970149,1,468,0.213219616,720,52,11.08742004,0.18336887
Bangladesh,2016,76,88,86,2,97.72727273,1,87,1.136363636,90,39,44.31818182,0.863636364
Bangladesh,2017,25,41,36,5,87.80487805,3,38,7.317073171,73,17,41.46341463,0.609756098
Barbados,1976,73,2,2,0,100,0,2,0,0,1,50,36.5
Barbados,1992,3,1,1,0,100,0,1,0,3,1,100,3
Belarus,1994,0,1,1,0,100,0,1,0,0,0,0,0
Belarus,1997,1,2,2,0,100,0,2,0,0,1,50,0.5
Belarus,1999,0,1,1,0,100,0,1,0,0,0,0,0
Belarus,2001,0,1,1,0,100,0,1,0,0,0,0,0
Belarus,2006,0,1,1,0,100,0,1,0,1,0,0,0
Belarus,2008,0,1,1,0,100,0,1,0,50,0,0,0
Belarus,2010,0,2,2,0,100,0,2,0,0,0,0,0
Belarus,2011,13,1,1,0,100,0,1,0,161,1,100,13
Belarus,2012,0,3,3,0,100,0,3,0,0,0,0,0
Belgium,1970,0,1,0,1,0,0,1,0,0,0,0,0
Belgium,1972,0,4,0,4,0,0,4,0,1,0,0,0
Belgium,1973,0,1,1,0,100,0,1,0,0,0,0,0
Belgium,1974,0,5,3,2,60,0,5,0,1,0,0,0
Belgium,1976,0,1,1,0,100,0,1,0,0,0,0,0
Belgium,1977,0,1,1,0,100,0,1,0,0,0,0,0
Belgium,1978,1,8,6,2,75,0,8,0,0,1,12.5,0.125
Belgium,1979,1,8,6,2,75,0,8,0,42,1,12.5,0.125
Belgium,1980,2,8,7,1,87.5,0,8,0,20,2,25,0.25
Belgium,1981,6,6,5,1,83.33333333,0,6,0,97,3,50,1
Belgium,1982,0,1,1,0,100,0,1,0,4,0,0,0
Belgium,1983,2,8,8,0,100,0,8,0,7,2,25,0.25
Belgium,1984,0,10,9,1,90,0,10,0,1,0,0,0
Belgium,1985,10,21,21,0,100,0,21,0,20,3,14.28571429,0.476190476
Belgium,1986,0,3,3,0,100,0,3,0,2,0,0,0
Belgium,1987,1,1,1,0,100,0,1,0,0,1,100,1
Belgium,1988,1,5,5,0,100,0,5,0,0,1,20,0.2
Belgium,1989,4,7,6,1,85.71428571,0,7,0,3,3,42.85714286,0.571428571
Belgium,1990,2,2,2,0,100,0,2,0,0,2,100,1
Belgium,1991,1,6,5,1,83.33333333,0,6,0,0,1,16.66666667,0.166666667
Belgium,1992,1,9,9,0,100,0,9,0,0,1,11.11111111,0.111111111
Belgium,1994,0,5,4,1,80,0,5,0,16,0,0,0
Belgium,1995,0,1,0,1,0,0,1,0,0,0,0,0
Belgium,1997,4,2,2,0,100,0,2,0,0,1,50,2
Belgium,1998,0,3,2,1,66.66666667,0,3,0,0,0,0,0
Belgium,1999,0,2,2,0,100,0,2,0,0,0,0,0
Belgium,2002,0,3,2,1,66.66666667,0,3,0,0,0,0,0
Belgium,2003,0,8,1,7,12.5,0,8,0,20,0,0,0
Belgium,2007,0,1,1,0,100,0,1,0,0,0,0,0
Belgium,2009,0,1,1,0,100,0,1,0,0,0,0,0
Belgium,2012,1,1,1,0,100,0,1,0,1,1,100,1
Belgium,2014,4,2,2,0,100,0,2,0,3,1,50,2
Belgium,2016,36,6,5,1,83.33333333,2,4,33.33333333,276,3,50,6
Belgium,2017,2,3,2,1,66.66666667,1,2,33.33333333,2,2,66.66666667,0.666666667
Belize,1980,0,1,1,0,100,0,1,0,0,0,0,0
Belize,1991,2,3,3,0,100,0,3,0,0,1,33.33333333,0.666666667
Belize,1992,1,2,1,1,50,0,2,0,0,1,50,0.5
Belize,2000,0,1,1,0,100,0,1,0,0,0,0,0
Belize,2013,0,1,1,0,100,0,1,0,0,0,0,0
Benin,1992,0,1,1,0,100,0,1,0,1,0,0,0
Benin,1994,0,3,3,0,100,0,3,0,3,0,0,0
Benin,1995,0,1,1,0,100,0,1,0,0,0,0,0
Benin,1996,0,2,2,0,100,0,2,0,0,0,0,0
Benin,2007,0,1,1,0,100,0,1,0,4,0,0,0
Bhutan,2006,4,1,1,0,100,0,1,0,0,1,100,4
Bhutan,2008,5,3,3,0,100,0,3,0,3,2,66.66666667,1.666666667
Bhutan,2011,0,1,1,0,100,0,1,0,2,0,0,0
Bhutan,2014,0,1,1,0,100,0,1,0,0,0,0,0
Bolivia,1970,0,1,1,0,100,0,1,0,0,0,0,0
Bolivia,1971,0,2,2,0,100,0,2,0,0,0,0,0
Bolivia,1974,0,1,1,0,100,0,1,0,0,0,0,0
Bolivia,1976,0,1,1,0,100,0,1,0,0,0,0,0
Bolivia,1977,0,1,1,0,100,0,1,0,0,0,0,0
Bolivia,1978,0,3,2,1,66.66666667,0,3,0,0,0,0,0
Bolivia,1979,0,14,13,1,92.85714286,0,14,0,7,0,0,0
Bolivia,1980,11,35,34,1,97.14285714,0,35,0,51,6,17.14285714,0.314285714
Bolivia,1981,1,5,4,1,80,0,5,0,1,1,20,0.2
Bolivia,1982,0,27,26,1,96.2962963,0,27,0,1,0,0,0
Bolivia,1983,0,27,26,1,96.2962963,0,27,0,3,0,0,0
Bolivia,1984,1,14,11,3,78.57142857,0,14,0,3,1,7.142857143,0.071428571
Bolivia,1985,0,13,12,1,92.30769231,0,13,0,0,0,0,0
Bolivia,1986,1,4,3,1,75,0,4,0,0,1,25,0.25
Bolivia,1987,1,14,13,1,92.85714286,0,14,0,25,1,7.142857143,0.071428571
Bolivia,1988,2,11,8,3,72.72727273,0,11,0,0,2,18.18181818,0.181818182
Bolivia,1989,2,40,37,3,92.5,0,40,0,0,1,2.5,0.05
Bolivia,1990,6,11,10,1,90.90909091,0,11,0,33,2,18.18181818,0.545454545
Bolivia,1991,7,28,18,10,64.28571429,0,28,0,1,5,17.85714286,0.25
Bolivia,1992,5,38,29,9,76.31578947,0,38,0,4,4,10.52631579,0.131578947
Bolivia,1994,1,8,7,1,87.5,0,8,0,21,1,12.5,0.125
Bolivia,1995,0,2,1,1,50,0,2,0,0,0,0,0
Bolivia,1996,0,1,1,0,100,0,1,0,0,0,0,0
Bolivia,1997,4,4,3,1,75,0,4,0,7,1,25,1
Bolivia,2003,0,1,1,0,100,0,1,0,0,0,0,0
Bolivia,2005,0,1,1,0,100,0,1,0,0,0,0,0
Bolivia,2007,0,3,3,0,100,0,3,0,0,0,0,0
Bolivia,2009,0,3,3,0,100,0,3,0,7,0,0,0
Bolivia,2012,0,1,1,0,100,0,1,0,2,0,0,0
Bosnia-Herzegovina,1992,55,22,22,0,100,0,22,0,22,9,40.90909091,2.5
Bosnia-Herzegovina,1994,3,9,9,0,100,0,9,0,5,2,22.22222222,0.333333333
Bosnia-Herzegovina,1995,2,6,3,3,50,0,6,0,3,2,33.33333333,0.333333333
Bosnia-Herzegovina,1996,2,33,32,1,96.96969697,0,33,0,12,2,6.060606061,0.060606061
Bosnia-Herzegovina,1997,5,42,40,2,95.23809524,0,42,0,68,4,9.523809524,0.119047619
Bosnia-Herzegovina,1998,2,9,9,0,100,0,9,0,3,2,22.22222222,0.222222222
Bosnia-Herzegovina,1999,1,5,5,0,100,0,5,0,4,1,20,0.2
Bosnia-Herzegovina,2000,1,6,6,0,100,0,6,0,3,1,16.66666667,0.166666667
Bosnia-Herzegovina,2001,0,2,2,0,100,0,2,0,0,0,0,0
Bosnia-Herzegovina,2002,0,3,3,0,100,0,3,0,0,0,0,0
Bosnia-Herzegovina,2003,0,1,1,0,100,0,1,0,0,0,0,0
Bosnia-Herzegovina,2005,0,1,1,0,100,0,1,0,1,0,0,0
Bosnia-Herzegovina,2006,0,1,1,0,100,0,1,0,0,0,0,0
Bosnia-Herzegovina,2007,1,2,2,0,100,0,2,0,2,1,50,0.5
Bosnia-Herzegovina,2008,2,4,4,0,100,0,4,0,10,2,50,0.5
Bosnia-Herzegovina,2009,0,1,1,0,100,0,1,0,0,0,0,0
Bosnia-Herzegovina,2010,1,1,1,0,100,0,1,0,6,1,100,1
Bosnia-Herzegovina,2011,0,1,1,0,100,0,1,0,1,0,0,0
Bosnia-Herzegovina,2013,0,1,1,0,100,0,1,0,0,0,0,0
Bosnia-Herzegovina,2014,0,3,1,2,33.33333333,0,3,0,4,0,0,0
Bosnia-Herzegovina,2015,4,6,6,0,100,0,6,0,6,2,33.33333333,0.666666667
Botswana,1974,1,1,1,0,100,0,1,0,0,1,100,1
Botswana,1985,0,1,1,0,100,0,1,0,1,0,0,0
Botswana,1987,3,1,1,0,100,0,1,0,4,1,100,3
Botswana,1988,1,3,3,0,100,0,3,0,5,1,33.33333333,0.333333333
Botswana,1989,0,2,2,0,100,0,2,0,0,0,0,0
Botswana,1990,6,1,1,0,100,0,1,0,0,1,100,6
Botswana,1995,0,1,1,0,100,0,1,0,1,0,0,0
Brazil,1970,2,6,3,3,50,0,6,0,1,2,33.33333333,0.333333333
Brazil,1971,0,3,3,0,100,0,3,0,0,0,0,0
Brazil,1972,0,3,0,3,0,0,3,0,1,0,0,0
Brazil,1973,0,2,2,0,100,0,2,0,15,0,0,0
Brazil,1976,0,5,5,0,100,0,5,0,1,0,0,0
Brazil,1977,0,1,0,1,0,0,1,0,1,0,0,0
Brazil,1978,1,5,5,0,100,0,5,0,1,1,20,0.2
Brazil,1979,4,6,6,0,100,0,6,0,0,3,50,0.666666667
Brazil,1980,19,19,18,1,94.73684211,0,19,0,3,6,31.57894737,1
Brazil,1981,2,11,10,1,90.90909091,0,11,0,3,2,18.18181818,0.181818182
Brazil,1982,27,4,3,1,75,0,4,0,0,3,75,6.75
Brazil,1983,0,8,6,2,75,0,8,0,12,0,0,0
Brazil,1984,0,5,5,0,100,0,5,0,1,0,0,0
Brazil,1985,0,1,1,0,100,0,1,0,0,0,0,0
Brazil,1986,14,3,3,0,100,0,3,0,0,2,66.66666667,4.666666667
Brazil,1987,0,1,1,0,100,0,1,0,11,0,0,0
Brazil,1988,0,2,2,0,100,0,2,0,0,0,0,0
Brazil,1989,1,5,3,2,60,0,5,0,0,1,20,0.2
Brazil,1990,3,7,6,1,85.71428571,0,7,0,4,3,42.85714286,0.428571429
Brazil,1991,12,24,18,6,75,0,24,0,17,8,33.33333333,0.5
Brazil,1992,28,24,18,6,75,0,24,0,10,7,29.16666667,1.166666667
Brazil,1994,15,19,18,1,94.73684211,0,19,0,4,10,52.63157895,0.789473684
Brazil,1995,13,23,22,1,95.65217391,0,23,0,40,5,21.73913043,0.565217391
Brazil,1996,22,18,17,1,94.44444444,0,18,0,9,7,38.88888889,1.222222222
Brazil,1997,28,39,38,1,97.43589744,0,39,0,15,15,38.46153846,0.717948718
Brazil,1998,0,2,2,0,100,0,2,0,0,0,0,0
Brazil,1999,1,1,1,0,100,0,1,0,0,1,100,1
Brazil,2000,0,2,1,1,50,0,2,0,0,0,0,0
Brazil,2001,1,3,3,0,100,0,3,0,0,1,33.33333333,0.333333333
Brazil,2002,0,1,1,0,100,0,1,0,0,0,0,0
Brazil,2003,0,1,0,1,0,0,1,0,0,0,0,0
Brazil,2006,1,3,2,1,66.66666667,0,3,0,11,1,33.33333333,0.333333333
Brazil,2012,1,1,1,0,100,0,1,0,0,1,100,1
Brazil,2013,2,3,2,1,66.66666667,0,3,0,0,2,66.66666667,0.666666667
Brazil,2014,2,3,3,0,100,0,3,0,0,2,66.66666667,0.666666667
Brazil,2015,3,5,4,1,80,0,5,0,0,3,60,0.6
Brazil,2016,1,2,2,0,100,0,2,0,0,1,50,0.5
Brazil,2017,0,2,2,0,100,0,2,0,0,0,0,0
Brunei,1972,0,5,0,5,0,0,5,0,0,0,0,0
Brunei,1992,0,1,0,1,0,0,1,0,1,0,0,0
Bulgaria,1982,2,2,2,0,100,0,2,0,0,2,100,1
Bulgaria,1984,0,1,1,0,100,0,1,0,0,0,0,0
Bulgaria,1990,0,5,5,0,100,0,5,0,0,0,0,0
Bulgaria,1991,0,3,3,0,100,0,3,0,0,0,0,0
Bulgaria,1992,0,2,2,0,100,0,2,0,0,0,0,0
Bulgaria,1994,1,2,2,0,100,0,2,0,1,1,50,0.5
Bulgaria,1995,3,2,1,1,50,0,2,0,0,2,100,1.5
Bulgaria,1996,9,12,11,1,91.66666667,0,12,0,3,5,41.66666667,0.75
Bulgaria,1997,0,3,2,1,66.66666667,0,3,0,0,0,0,0
Bulgaria,1998,0,2,2,0,100,0,2,0,1,0,0,0
Bulgaria,1999,0,1,1,0,100,0,1,0,0,0,0,0
Bulgaria,2000,4,2,2,0,100,0,2,0,0,2,100,2
Bulgaria,2001,0,1,1,0,100,0,1,0,0,0,0,0
Bulgaria,2002,1,1,1,0,100,0,1,0,0,1,100,1
Bulgaria,2008,0,2,1,1,50,0,2,0,0,0,0,0
Bulgaria,2011,0,2,2,0,100,0,2,0,0,0,0,0
Bulgaria,2012,8,2,2,0,100,1,1,50,30,2,100,4
Bulgaria,2013,0,3,1,2,33.33333333,0,3,0,0,0,0,0
Bulgaria,2014,0,1,1,0,100,0,1,0,0,0,0,0
Bulgaria,2015,0,2,2,0,100,0,2,0,0,0,0,0
Bulgaria,2016,0,1,1,0,100,0,1,0,1,0,0,0
Burkina Faso,1984,1,1,1,0,100,0,1,0,0,1,100,1
Burkina Faso,1991,1,2,1,1,50,0,2,0,2,1,50,0.5
Burkina Faso,2013,1,1,0,1,0,0,1,0,0,1,100,1
Burkina Faso,2015,16,6,6,0,100,0,6,0,132,4,66.66666667,2.666666667
Burkina Faso,2016,62,10,10,0,100,0,10,0,40,8,80,6.2
Burkina Faso,2017,53,32,27,5,84.375,0,32,0,45,16,50,1.65625
Burundi,1991,117,7,7,0,100,0,7,0,41,7,100,16.71428571
Burundi,1992,61,2,1,1,50,0,2,0,19,1,50,30.5
Burundi,1994,265,16,16,0,100,0,16,0,158,14,87.5,16.5625
Burundi,1995,583,83,81,2,97.59036145,0,83,0,300,61,73.4939759,7.024096386
Burundi,1996,1371,35,34,1,97.14285714,0,35,0,286,32,91.42857143,39.17142857
Burundi,1997,386,79,79,0,100,0,79,0,507,36,45.56962025,4.886075949
Burundi,1998,392,13,13,0,100,0,13,0,129,13,100,30.15384615
Burundi,1999,108,13,13,0,100,0,13,0,63,11,84.61538462,8.307692308
Burundi,2000,97,17,17,0,100,0,17,0,23,13,76.47058824,5.705882353
Burundi,2001,166,37,36,1,97.2972973,0,37,0,49,27,72.97297297,4.486486486
Burundi,2002,67,18,18,0,100,0,18,0,56,14,77.77777778,3.722222222
Burundi,2003,116,18,18,0,100,0,18,0,24,14,77.77777778,6.444444444
Burundi,2004,18,1,1,0,100,0,1,0,0,1,100,18
Burundi,2005,13,5,5,0,100,0,5,0,17,4,80,2.6
Burundi,2006,21,5,5,0,100,0,5,0,54,5,100,4.2
Burundi,2007,3,3,3,0,100,0,3,0,2,2,66.66666667,1
Burundi,2008,28,7,6,1,85.71428571,0,7,0,46,3,42.85714286,4
Burundi,2010,14,29,28,1,96.55172414,0,29,0,55,6,20.68965517,0.482758621
Burundi,2011,47,8,8,0,100,0,8,0,30,6,75,5.875
Burundi,2012,6,4,4,0,100,0,4,0,22,3,75,1.5
Burundi,2013,5,2,2,0,100,0,2,0,12,2,100,2.5
Burundi,2014,4,5,5,0,100,0,5,0,1,2,40,0.8
Burundi,2015,223,102,95,7,93.1372549,0,102,0,220,59,57.84313725,2.18627451
Burundi,2016,74,83,75,8,90.36144578,0,83,0,213,44,53.01204819,0.891566265
Burundi,2017,20,21,20,1,95.23809524,0,21,0,127,9,42.85714286,0.952380952
Cambodia,1971,2,2,1,1,50,0,2,0,10,1,50,1
Cambodia,1972,1,2,1,1,50,0,2,0,0,1,50,0.5
Cambodia,1978,1,1,1,0,100,0,1,0,0,1,100,1
Cambodia,1989,11,2,2,0,100,0,2,0,0,2,100,5.5
Cambodia,1990,0,2,2,0,100,0,2,0,0,0,0,0
Cambodia,1991,16,3,3,0,100,0,3,0,18,1,33.33333333,5.333333333
Cambodia,1992,64,67,64,3,95.52238806,0,67,0,148,17,25.37313433,0.955223881
Cambodia,1994,225,39,38,1,97.43589744,0,39,0,88,22,56.41025641,5.769230769
Cambodia,1995,21,56,55,1,98.21428571,0,56,0,98,6,10.71428571,0.375
Cambodia,1996,44,33,30,3,90.90909091,0,33,0,78,11,33.33333333,1.333333333
Cambodia,1997,100,18,18,0,100,0,18,0,284,10,55.55555556,5.555555556
Cambodia,1998,35,7,5,2,71.42857143,0,7,0,5,4,57.14285714,5
Cambodia,1999,1,8,6,2,75,0,8,0,18,1,12.5,0.125
Cambodia,2000,12,4,4,0,100,0,4,0,23,2,50,3
Cambodia,2001,4,7,7,0,100,0,7,0,13,2,28.57142857,0.571428571
Cambodia,2002,4,3,3,0,100,0,3,0,1,3,100,1.333333333
Cambodia,2003,1,1,1,0,100,0,1,0,0,1,100,1
Cambodia,2008,1,2,2,0,100,0,2,0,2,1,50,0.5
Cambodia,2013,0,2,0,2,0,0,2,0,0,0,0,0
Cameroon,1991,36,4,4,0,100,0,4,0,0,3,75,9
Cameroon,1992,6,6,6,0,100,0,6,0,5,5,83.33333333,1
Cameroon,1994,33,6,6,0,100,0,6,0,6,5,83.33333333,5.5
Cameroon,1995,5,2,2,0,100,0,2,0,1,1,50,2.5
Cameroon,1998,0,1,1,0,100,0,1,0,0,0,0,0
Cameroon,2007,31,1,1,0,100,0,1,0,0,1,100,31
Cameroon,2008,3,1,1,0,100,0,1,0,0,1,100,3
Cameroon,2009,0,1,1,0,100,0,1,0,0,0,0,0
Cameroon,2010,5,3,3,0,100,0,3,0,2,1,33.33333333,1.666666667
Cameroon,2011,4,3,3,0,100,0,3,0,0,2,66.66666667,1.333333333
Cameroon,2013,7,3,3,0,100,0,3,0,0,1,33.33333333,2.333333333
Cameroon,2014,789,68,66,2,97.05882353,0,68,0,19,46,67.64705882,11.60294118
Cameroon,2015,931,83,79,4,95.18072289,23,60,27.71084337,463,64,77.10843373,11.21686747
Cameroon,2016,269,56,47,9,83.92857143,28,28,50,324,42,75,4.803571429
Cameroon,2017,228,94,86,8,91.4893617,37,57,39.36170213,243,68,72.34042553,2.425531915
Canada,1970,1,2,2,0,100,0,2,0,0,1,50,0.5
Canada,1972,1,4,3,1,75,0,4,0,7,1,25,0.25
Canada,1974,0,1,0,1,0,0,1,0,0,0,0,0
Canada,1980,0,3,3,0,100,0,3,0,0,0,0,0
Canada,1982,1,5,4,1,80,0,5,0,8,1,20,0.2
Canada,1983,0,1,1,0,100,0,1,0,0,0,0,0
Canada,1985,331,3,3,0,100,0,3,0,2,3,100,110.3333333
Canada,1986,0,2,1,1,50,0,2,0,1,0,0,0
Canada,1989,15,1,1,0,100,1,0,100,14,1,100,15
Canada,1992,0,3,2,1,66.66666667,0,3,0,2,0,0,0
Canada,1994,0,4,1,3,25,0,4,0,1,0,0,0
Canada,1995,1,5,2,3,40,0,5,0,1,1,20,0.2
Canada,1996,0,1,1,0,100,0,1,0,1,0,0,0
Canada,1997,0,2,1,1,50,0,2,0,1,0,0,0
Canada,1998,1,4,3,1,75,0,4,0,0,1,25,0.25
Canada,1999,0,2,1,1,50,0,2,0,2,0,0,0
Canada,2000,0,5,4,1,80,0,5,0,30,0,0,0
Canada,2004,0,2,2,0,100,0,2,0,0,0,0,0
Canada,2006,0,2,2,0,100,0,2,0,0,0,0,0
Canada,2008,0,5,5,0,100,0,5,0,9,0,0,0
Canada,2009,0,4,4,0,100,0,4,0,0,0,0,0
Canada,2010,0,2,1,1,50,0,2,0,0,0,0,0
Canada,2012,0,3,1,2,33.33333333,0,3,0,0,0,0,0
Canada,2013,0,4,1,3,25,0,4,0,0,0,0,0
Canada,2014,7,3,3,0,100,0,3,0,6,3,100,2.333333333
Canada,2015,0,5,5,0,100,0,5,0,2,0,0,0
Canada,2016,1,6,6,0,100,0,6,0,34,1,16.66666667,0.166666667
Canada,2017,6,12,12,0,100,0,12,0,25,1,8.333333333,0.5
Central African Republic,1981,3,1,1,0,100,0,1,0,0,1,100,3
Central African Republic,1986,0,1,1,0,100,0,1,0,0,0,0,0
Central African Republic,1991,3,4,4,0,100,0,4,0,7,2,50,0.75
Central African Republic,1992,1,1,1,0,100,0,1,0,0,1,100,1
Central African Republic,1994,2,1,1,0,100,0,1,0,5,1,100,2
Central African Republic,1996,2,1,1,0,100,0,1,0,0,1,100,2
Central African Republic,2000,1,1,1,0,100,0,1,0,0,1,100,1
Central African Republic,2001,7,1,1,0,100,0,1,0,0,1,100,7
Central African Republic,2006,4,1,1,0,100,0,1,0,1,1,100,4
Central African Republic,2007,1,1,1,0,100,0,1,0,0,1,100,1
Central African Republic,2008,1,2,2,0,100,0,2,0,0,1,50,0.5
Central African Republic,2009,38,5,5,0,100,0,5,0,14,4,80,7.6
Central African Republic,2010,46,13,13,0,100,0,13,0,23,8,61.53846154,3.538461538
Central African Republic,2011,35,3,3,0,100,0,3,0,3,3,100,11.66666667
Central African Republic,2012,14,4,4,0,100,0,4,0,16,2,50,3.5
Central African Republic,2013,120,20,16,4,80,0,20,0,71,11,55,6
Central African Republic,2014,751,94,91,3,96.80851064,0,94,0,298,61,64.89361702,7.989361702
Central African Republic,2015,171,48,45,3,93.75,0,48,0,91,32,66.66666667,3.5625
Central African Republic,2016,189,38,33,5,86.84210526,0,38,0,174,21,55.26315789,4.973684211
Central African Republic,2017,601,43,38,5,88.37209302,0,43,0,239,33,76.74418605,13.97674419
Central America & Caribbean,1970,3,7,7,0,100,0,7,0,0,3,42.85714286,0.428571429
Central America & Caribbean,1971,0,5,4,1,80,0,5,0,0,0,0,0
Central America & Caribbean,1972,0,3,3,0,100,0,3,0,0,0,0,0
Central America & Caribbean,1973,0,6,4,2,66.66666667,0,6,0,0,0,0,0
Central America & Caribbean,1974,0,11,11,0,100,0,11,0,3,0,0,0
Central America & Caribbean,1975,36,9,8,1,88.88888889,0,9,0,1,5,55.55555556,4
Central America & Caribbean,1976,84,45,44,1,97.77777778,0,45,0,18,10,22.22222222,1.866666667
Central America & Caribbean,1977,36,24,24,0,100,0,24,0,12,10,41.66666667,1.5
Central America & Caribbean,1978,164,199,192,7,96.48241206,0,199,0,143,64,32.16080402,0.824120603
Central America & Caribbean,1979,536,609,585,24,96.0591133,0,609,0,189,220,36.12479475,0.880131363
Central America & Caribbean,1980,2976,1070,1033,37,96.54205607,0,1070,0,467,566,52.89719626,2.781308411
Central America & Caribbean,1981,3151,1148,1114,34,97.03832753,0,1148,0,703,468,40.76655052,2.744773519
Central America & Caribbean,1982,3398,996,979,17,98.29317269,0,996,0,393,364,36.54618474,3.411646586
Central America & Caribbean,1983,5554,858,840,18,97.9020979,0,858,0,1001,340,39.62703963,6.473193473
Central America & Caribbean,1984,5112,681,664,17,97.50367107,0,681,0,837,296,43.46549192,7.50660793
Central America & Caribbean,1985,2734,780,775,5,99.35897436,0,780,0,553,265,33.97435897,3.505128205
Central America & Caribbean,1986,755,393,385,8,97.96437659,0,393,0,311,126,32.0610687,1.921119593
Central America & Caribbean,1987,1214,566,549,17,96.99646643,0,566,0,671,172,30.38869258,2.144876325
Central America & Caribbean,1988,739,495,485,10,97.97979798,0,495,0,500,144,29.09090909,1.492929293
Central America & Caribbean,1989,452,503,481,22,95.62624254,0,503,0,741,145,28.82703777,0.89860835
Central America & Caribbean,1990,406,316,301,15,95.25316456,0,316,0,450,81,25.63291139,1.284810127
Central America & Caribbean,1991,714,729,710,19,97.39368999,0,729,0,1107,164,22.49657064,0.979423868
Central America & Caribbean,1992,112,212,193,19,91.03773585,0,212,0,164,61,28.77358491,0.528301887
Central America & Caribbean,1994,184,180,151,29,83.88888889,1,179,0.555555556,178,55,30.55555556,1.022222222
Central America & Caribbean,1995,81,168,152,16,90.47619048,0,168,0,104,67,39.88095238,0.482142857
Central America & Caribbean,1996,88,116,100,16,86.20689655,0,116,0,137,42,36.20689655,0.75862069
Central America & Caribbean,1997,73,117,105,12,89.74358974,0,117,0,135,41,35.04273504,0.623931624
Central America & Caribbean,1998,0,1,1,0,100,0,1,0,0,0,0,0
Central America & Caribbean,1999,6,8,6,2,75,0,8,0,3,4,50,0.75
Central America & Caribbean,2000,11,14,13,1,92.85714286,0,14,0,28,7,50,0.785714286
Central America & Caribbean,2001,2,8,5,3,62.5,0,8,0,3,2,25,0.25
Central America & Caribbean,2002,0,3,2,1,66.66666667,0,3,0,1,0,0,0
Central America & Caribbean,2003,5,8,6,2,75,0,8,0,6,2,25,0.625
Central America & Caribbean,2004,38,5,5,0,100,0,5,0,44,5,100,7.6
Central America & Caribbean,2005,1,3,3,0,100,0,3,0,14,1,33.33333333,0.333333333
Central America & Caribbean,2006,7,5,5,0,100,0,5,0,1,5,100,1.4
Central America & Caribbean,2007,2,4,3,1,75,0,4,0,2,2,50,0.5
Central America & Caribbean,2008,0,0,0,0,0,0,0,0,0,0,,
Central America & Caribbean,2009,3,9,7,2,77.77777778,0,9,0,1,2,22.22222222,0.333333333
Central America & Caribbean,2010,0,1,1,0,100,0,1,0,0,0,0,0
Central America & Caribbean,2011,2,1,1,0,100,0,1,0,0,1,100,2
Central America & Caribbean,2012,2,1,1,0,100,0,1,0,1,1,100,2
Central America & Caribbean,2013,9,14,11,3,78.57142857,0,14,0,3,5,35.71428571,0.642857143
Central America & Caribbean,2014,5,5,3,2,60,0,5,0,65,2,40,1
Central America & Caribbean,2015,0,1,0,1,0,0,1,0,0,0,0,0
Central America & Caribbean,2016,9,3,3,0,100,0,3,0,0,2,66.66666667,3
Central America & Caribbean,2017,4,4,4,0,100,0,4,0,1,2,50,1
Central Asia,1970,0,0,0,0,0,0,0,0,0,0,,
Central Asia,1971,0,0,0,0,0,0,0,0,0,0,,
Central Asia,1972,0,0,0,0,0,0,0,0,0,0,,
Central Asia,1973,0,0,0,0,0,0,0,0,0,0,,
Central Asia,1974,0,0,0,0,0,0,0,0,0,0,,
Central Asia,1975,0,0,0,0,0,0,0,0,0,0,,
Central Asia,1976,0,0,0,0,0,0,0,0,0,0,,
Central Asia,1977,0,0,0,0,0,0,0,0,0,0,,
Central Asia,1978,0,0,0,0,0,0,0,0,0,0,,
Central Asia,1979,0,0,0,0,0,0,0,0,0,0,,
Central Asia,1980,0,0,0,0,0,0,0,0,0,0,,
Central Asia,1981,0,0,0,0,0,0,0,0,0,0,,
Central Asia,1982,0,0,0,0,0,0,0,0,0,0,,
Central Asia,1983,0,0,0,0,0,0,0,0,0,0,,
Central Asia,1984,0,0,0,0,0,0,0,0,0,0,,
Central Asia,1985,0,0,0,0,0,0,0,0,0,0,,
Central Asia,1986,0,0,0,0,0,0,0,0,0,0,,
Central Asia,1987,0,0,0,0,0,0,0,0,0,0,,
Central Asia,1988,0,0,0,0,0,0,0,0,0,0,,
Central Asia,1989,0,0,0,0,0,0,0,0,0,0,,
Central Asia,1990,0,0,0,0,0,0,0,0,0,0,,
Central Asia,1991,28,7,7,0,100,0,7,0,12,3,42.85714286,4
Central Asia,1992,320,77,74,3,96.1038961,0,77,0,907,38,49.35064935,4.155844156
Central Asia,1994,122,65,60,5,92.30769231,0,65,0,258,39,60,1.876923077
Central Asia,1995,94,55,48,7,87.27272727,0,55,0,66,38,69.09090909,1.709090909
Central Asia,1996,56,33,32,1,96.96969697,0,33,0,44,19,57.57575758,1.696969697
Central Asia,1997,81,49,47,2,95.91836735,0,49,0,47,28,57.14285714,1.653061224
Central Asia,1998,61,25,23,2,92,0,25,0,51,15,60,2.44
Central Asia,1999,35,24,24,0,100,0,24,0,167,13,54.16666667,1.458333333
Central Asia,2000,18,21,20,1,95.23809524,0,21,0,89,10,47.61904762,0.857142857
Central Asia,2001,16,18,17,1,94.44444444,0,18,0,27,9,50,0.888888889
Central Asia,2002,3,6,5,1,83.33333333,0,6,0,18,2,33.33333333,0.5
Central Asia,2003,1,7,7,0,100,0,7,0,1,1,14.28571429,0.142857143
Central Asia,2004,36,8,5,3,62.5,5,3,62.5,32,5,62.5,4.5
Central Asia,2005,18,11,7,4,63.63636364,0,11,0,66,4,36.36363636,1.636363636
Central Asia,2006,6,6,4,2,66.66666667,0,6,0,6,4,66.66666667,1
Central Asia,2007,1,4,4,0,100,0,4,0,1,1,25,0.25
Central Asia,2008,20,36,33,3,91.66666667,0,36,0,77,10,27.77777778,0.555555556
Central Asia,2009,10,31,30,1,96.77419355,1,30,3.225806452,30,8,25.80645161,0.322580645
Central Asia,2010,8,9,8,1,88.88888889,1,8,11.11111111,43,4,44.44444444,0.888888889
Central Asia,2011,13,9,7,2,77.77777778,2,7,22.22222222,3,5,55.55555556,1.444444444
Central Asia,2012,6,12,8,4,66.66666667,0,12,0,11,5,41.66666667,0.5
Central Asia,2013,2,7,3,4,42.85714286,0,7,0,2,1,14.28571429,0.285714286
Central Asia,2014,5,9,7,2,77.77777778,0,9,0,7,3,33.33333333,0.555555556
Central Asia,2015,13,10,6,4,60,0,10,0,12,4,40,1.3
Central Asia,2016,21,17,13,4,76.47058824,2,15,11.76470588,25,9,52.94117647,1.235294118
Central Asia,2017,6,7,6,1,85.71428571,0,7,0,7,2,28.57142857,0.857142857
Chad,1974,0,1,1,0,100,0,1,0,0,0,0,0
Chad,1984,0,1,1,0,100,0,1,0,25,0,0,0
Chad,1985,0,1,1,0,100,0,1,0,0,0,0,0
Chad,1986,0,1,1,0,100,0,1,0,1,0,0,0
Chad,1991,40,2,2,0,100,0,2,0,0,1,50,20
Chad,1992,170,4,4,0,100,0,4,0,0,3,75,42.5
Chad,1994,1,1,1,0,100,0,1,0,3,1,100,1
Chad,1995,0,3,3,0,100,0,3,0,0,0,0,0
Chad,1996,1,1,1,0,100,0,1,0,0,1,100,1
Chad,1997,2,1,1,0,100,0,1,0,2,1,100,2
Chad,1998,0,1,1,0,100,0,1,0,0,0,0,0
Chad,1999,77,1,1,0,100,0,1,0,0,1,100,77
Chad,2002,21,4,3,1,75,0,4,0,1,2,50,5.25
Chad,2006,103,11,11,0,100,0,11,0,3,3,27.27272727,9.363636364
Chad,2007,136,7,6,1,85.71428571,0,7,0,138,5,71.42857143,19.42857143
Chad,2008,172,8,7,1,87.5,0,8,0,1011,6,75,21.5
Chad,2009,0,3,3,0,100,0,3,0,1,0,0,0
Chad,2010,0,1,1,0,100,0,1,0,0,0,0,0
Chad,2014,6,1,1,0,100,0,1,0,0,1,100,6
Chad,2015,306,27,27,0,100,13,14,48.14814815,427,26,96.2962963,11.33333333
Chad,2016,22,5,4,1,80,2,3,40,68,4,80,4.4
Chad,2017,62,6,6,0,100,0,6,0,1,3,50,10.33333333
Chile,1973,0,7,6,1,85.71428571,0,7,0,0,0,0,0
Chile,1976,0,2,1,1,50,0,2,0,1,0,0,0
Chile,1977,0,6,5,1,83.33333333,0,6,0,0,0,0,0
Chile,1978,0,8,8,0,100,0,8,0,2,0,0,0
Chile,1979,6,49,42,7,85.71428571,0,49,0,3,6,12.24489796,0.12244898
Chile,1980,6,41,35,6,85.36585366,0,41,0,11,5,12.19512195,0.146341463
Chile,1981,19,34,27,7,79.41176471,0,34,0,2,8,23.52941176,0.558823529
Chile,1982,2,21,19,2,90.47619048,0,21,0,2,2,9.523809524,0.095238095
Chile,1983,15,106,101,5,95.28301887,0,106,0,25,11,10.37735849,0.141509434
Chile,1984,37,563,550,13,97.69094139,0,563,0,158,23,4.085257549,0.065719361
Chile,1985,30,232,223,9,96.12068966,0,232,0,148,18,7.75862069,0.129310345
Chile,1986,22,243,234,9,96.2962963,0,243,0,128,13,5.349794239,0.090534979
Chile,1987,9,173,158,15,91.32947977,0,173,0,29,7,4.046242775,0.052023121
Chile,1988,19,185,168,17,90.81081081,0,185,0,81,16,8.648648649,0.102702703
Chile,1989,19,146,135,11,92.46575342,0,146,0,20,14,9.589041096,0.130136986
Chile,1990,8,161,155,6,96.27329193,0,161,0,38,7,4.347826087,0.049689441
Chile,1991,16,127,112,15,88.18897638,0,127,0,30,12,9.448818898,0.125984252
Chile,1992,12,116,111,5,95.68965517,0,116,0,13,7,6.034482759,0.103448276
Chile,1994,0,15,12,3,80,0,15,0,7,0,0,0
Chile,1995,1,17,16,1,94.11764706,0,17,0,5,1,5.882352941,0.058823529
Chile,1996,2,8,8,0,100,0,8,0,4,1,12.5,0.25
Chile,1997,0,6,6,0,100,0,6,0,10,0,0,0
Chile,1998,0,1,1,0,100,0,1,0,0,0,0,0
Chile,1999,0,3,3,0,100,0,3,0,0,0,0,0
Chile,2000,0,2,2,0,100,0,2,0,0,0,0,0
Chile,2001,0,3,1,2,33.33333333,0,3,0,0,0,0,0
Chile,2002,0,1,1,0,100,0,1,0,1,0,0,0
Chile,2003,0,2,2,0,100,0,2,0,0,0,0,0
Chile,2006,0,1,1,0,100,0,1,0,1,0,0,0
Chile,2007,0,8,8,0,100,0,8,0,0,0,0,0
Chile,2008,0,4,4,0,100,0,4,0,0,0,0,0
Chile,2009,0,8,6,2,75,0,8,0,1,0,0,0
Chile,2010,0,5,5,0,100,0,5,0,1,0,0,0
Chile,2011,0,6,6,0,100,0,6,0,1,0,0,0
Chile,2012,0,2,2,0,100,0,2,0,0,0,0,0
Chile,2013,2,5,5,0,100,0,5,0,1,1,20,0.4
Chile,2014,1,17,14,3,82.35294118,0,17,0,26,1,5.882352941,0.058823529
Chile,2015,0,1,1,0,100,0,1,0,0,0,0,0
Chile,2016,2,18,16,2,88.88888889,0,18,0,4,1,5.555555556,0.111111111
Chile,2017,0,12,11,1,91.66666667,0,12,0,2,0,0,0
China,1989,20,3,1,2,33.33333333,0,3,0,12,1,33.33333333,6.666666667
China,1990,2,1,1,0,100,0,1,0,10,1,100,2
China,1991,0,1,0,1,0,0,1,0,0,0,0,0
China,1992,9,5,4,1,80,0,5,0,20,3,60,1.8
China,1994,18,13,8,5,61.53846154,0,13,0,96,4,30.76923077,1.384615385
China,1995,6,8,7,1,87.5,0,8,0,198,3,37.5,0.75
China,1996,23,62,59,3,95.16129032,0,62,0,106,8,12.90322581,0.370967742
China,1997,37,18,15,3,83.33333333,1,17,5.555555556,104,7,38.88888889,2.055555556
China,1998,50,2,2,0,100,0,2,0,150,1,50,25
China,1999,5,2,2,0,100,0,2,0,50,2,100,2.5
China,2000,1,4,3,1,75,1,3,25,2,1,25,0.25
China,2001,7,12,9,3,75,1,11,8.333333333,37,5,41.66666667,0.583333333
China,2002,1,2,1,1,50,1,1,50,18,1,50,0.5
China,2003,1,3,3,0,100,0,3,0,16,1,33.33333333,0.333333333
China,2004,4,2,2,0,100,1,1,50,5,2,100,2
China,2005,12,1,1,0,100,0,1,0,2,1,100,12
China,2008,39,20,17,3,85,2,18,10,150,13,65,1.95
China,2009,186,7,7,0,100,1,6,14.28571429,56,3,42.85714286,26.57142857
China,2010,7,1,1,0,100,0,1,0,14,1,100,7
China,2011,19,4,4,0,100,0,4,0,32,2,50,4.75
China,2012,27,4,3,1,75,2,2,50,38,3,75,6.75
China,2013,60,12,12,0,100,0,12,0,71,10,83.33333333,5
China,2014,322,37,33,4,89.18918919,3,34,8.108108108,478,25,67.56756757,8.702702703
China,2015,123,17,14,3,82.35294118,3,14,17.64705882,83,13,76.47058824,7.235294118
China,2016,13,5,5,0,100,0,5,0,18,2,40,2.6
China,2017,16,6,6,0,100,1,5,16.66666667,76,2,33.33333333,2.666666667
Colombia,1970,0,1,1,0,100,0,1,0,0,0,0,0
Colombia,1972,1,2,2,0,100,0,2,0,0,1,50,0.5
Colombia,1973,0,6,6,0,100,0,6,0,0,0,0,0
Colombia,1975,7,10,10,0,100,0,10,0,0,5,50,0.7
Colombia,1976,10,22,21,1,95.45454545,0,22,0,13,6,27.27272727,0.454545455
Colombia,1977,38,80,77,3,96.25,0,80,0,29,20,25,0.475
Colombia,1978,71,158,154,4,97.46835443,0,158,0,23,40,25.3164557,0.449367089
Colombia,1979,156,140,134,6,95.71428571,0,140,0,54,67,47.85714286,1.114285714
Colombia,1980,159,141,109,32,77.30496454,0,141,0,32,48,34.04255319,1.127659574
Colombia,1981,365,172,165,7,95.93023256,0,172,0,49,86,50,2.122093023
Colombia,1982,368,222,210,12,94.59459459,0,222,0,111,90,40.54054054,1.657657658
Colombia,1983,437,234,226,8,96.58119658,0,234,0,75,124,52.99145299,1.867521368
Colombia,1984,485,237,220,17,92.82700422,0,237,0,296,119,50.21097046,2.046413502
Colombia,1985,935,382,344,38,90.05235602,0,382,0,365,168,43.97905759,2.447643979
Colombia,1986,771,307,298,9,97.06840391,0,307,0,96,187,60.91205212,2.511400651
Colombia,1987,655,337,319,18,94.65875371,0,337,0,277,205,60.83086053,1.943620178
Colombia,1988,1096,427,403,24,94.3793911,0,427,0,419,249,58.31381733,2.566744731
Colombia,1989,751,492,475,17,96.54471545,0,492,0,510,203,41.2601626,1.526422764
Colombia,1990,694,349,333,16,95.41547278,0,349,0,747,194,55.58739255,1.988538682
Colombia,1991,742,420,398,22,94.76190476,0,420,0,420,180,42.85714286,1.766666667
Colombia,1992,631,523,456,67,87.18929254,0,523,0,449,178,34.03441683,1.206500956
Colombia,1994,218,201,182,19,90.54726368,0,201,0,115,52,25.87064677,1.084577114
Colombia,1995,521,123,114,9,92.68292683,0,123,0,326,67,54.47154472,4.235772358
Colombia,1996,611,409,379,30,92.66503667,0,409,0,476,177,43.27628362,1.493887531
Colombia,1997,1230,598,570,28,95.31772575,0,598,0,637,270,45.15050167,2.056856187
Colombia,1998,592,94,89,5,94.68085106,0,94,0,176,26,27.65957447,6.29787234
Colombia,1999,262,116,108,8,93.10344828,0,116,0,246,34,29.31034483,2.25862069
Colombia,2000,426,137,132,5,96.35036496,0,137,0,181,49,35.76642336,3.109489051
Colombia,2001,576,207,195,12,94.20289855,0,207,0,435,99,47.82608696,2.782608696
Colombia,2002,356,150,145,5,96.66666667,0,150,0,648,69,46,2.373333333
Colombia,2003,184,98,92,6,93.87755102,3,95,3.06122449,557,43,43.87755102,1.87755102
Colombia,2004,83,37,35,2,94.59459459,1,36,2.702702703,213,20,54.05405405,2.243243243
Colombia,2005,145,42,42,0,100,0,42,0,106,30,71.42857143,3.452380952
Colombia,2006,79,43,42,1,97.6744186,0,43,0,94,24,55.81395349,1.837209302
Colombia,2007,64,30,29,1,96.66666667,0,30,0,103,21,70,2.133333333
Colombia,2008,85,133,115,18,86.46616541,0,133,0,238,37,27.81954887,0.639097744
Colombia,2009,107,139,125,14,89.92805755,0,139,0,226,41,29.49640288,0.769784173
Colombia,2010,56,136,100,36,73.52941176,0,136,0,141,17,12.5,0.411764706
Colombia,2011,43,94,79,15,84.04255319,0,94,0,85,26,27.65957447,0.457446809
Colombia,2012,168,115,110,5,95.65217391,0,115,0,456,51,44.34782609,1.460869565
Colombia,2013,137,149,137,12,91.94630872,0,149,0,263,51,34.22818792,0.919463087
Colombia,2014,143,231,199,32,86.14718615,0,231,0,314,72,31.16883117,0.619047619
Colombia,2015,104,136,124,12,91.17647059,0,136,0,138,44,32.35294118,0.764705882
Colombia,2016,52,109,95,14,87.1559633,0,109,0,72,34,31.19266055,0.47706422
Colombia,2017,84,117,113,4,96.58119658,0,117,0,117,54,46.15384615,0.717948718
Comoros,1992,1,1,0,1,0,0,1,0,0,1,100,1
Comoros,1994,0,1,0,1,0,0,1,0,0,0,0,0
Comoros,1997,0,3,3,0,100,0,3,0,2,0,0,0
Congo,1972,0,1,0,1,0,0,1,0,0,0,0,0
Congo,1977,0,2,2,0,100,0,2,0,0,0,0,0
Congo,1982,15,1,1,0,100,0,1,0,0,1,100,15
Congo,1990,0,1,1,0,100,0,1,0,0,0,0,0
Congo,1994,12,8,8,0,100,0,8,0,4,4,50,1.5
Congo,1996,0,1,1,0,100,0,1,0,0,0,0,0
Congo,1997,2,2,2,0,100,0,2,0,2,2,100,1
Congo,1999,107,3,2,1,66.66666667,0,3,0,0,2,66.66666667,35.66666667
Congo,2001,0,1,1,0,100,0,1,0,0,0,0,0
Congo,2002,17,3,3,0,100,0,3,0,42,3,100,5.666666667
Congo,2003,11,1,1,0,100,0,1,0,0,1,100,11
Congo,2013,2,1,1,0,100,0,1,0,5,1,100,2
Congo,2016,31,15,15,0,100,0,15,0,1,12,80,2.066666667
Costa Rica,1971,0,1,1,0,100,0,1,0,0,0,0,0
Costa Rica,1976,0,12,12,0,100,0,12,0,6,0,0,0
Costa Rica,1977,0,5,5,0,100,0,5,0,0,0,0,0
Costa Rica,1978,0,2,2,0,100,0,2,0,0,0,0,0
Costa Rica,1979,3,2,2,0,100,0,2,0,0,1,50,1.5
Costa Rica,1980,0,3,3,0,100,0,3,0,1,0,0,0
Costa Rica,1981,4,10,8,2,80,0,10,0,5,1,10,0.4
Costa Rica,1982,4,6,3,3,50,0,6,0,10,2,33.33333333,0.666666667
Costa Rica,1983,0,3,2,1,66.66666667,0,3,0,0,0,0,0
Costa Rica,1984,0,2,2,0,100,0,2,0,0,0,0,0
Costa Rica,1985,0,5,4,1,80,0,5,0,0,0,0,0
Costa Rica,1986,0,1,1,0,100,0,1,0,3,0,0,0
Costa Rica,1987,0,3,1,2,33.33333333,0,3,0,0,0,0,0
Costa Rica,1988,0,2,2,0,100,0,2,0,6,0,0,0
Costa Rica,1989,1,1,0,1,0,0,1,0,2,1,100,1
Costa Rica,1990,0,1,1,0,100,0,1,0,0,0,0,0
Costa Rica,1991,0,2,2,0,100,0,2,0,0,0,0,0
Costa Rica,1992,0,2,1,1,50,0,2,0,0,0,0,0
Costa Rica,1994,1,1,1,0,100,0,1,0,0,1,100,1
Costa Rica,1996,1,1,1,0,100,0,1,0,4,1,100,1
Costa Rica,1997,2,1,1,0,100,0,1,0,1,1,100,2
Costa Rica,2001,1,1,1,0,100,0,1,0,0,1,100,1
Cote d'Ivoire,1992,1,3,3,0,100,0,3,0,0,1,33.33333333,0.333333333
Cote d'Ivoire,1994,5,2,2,0,100,0,2,0,0,2,100,2.5
Cote d'Ivoire,1995,40,7,7,0,100,0,7,0,5,4,57.14285714,5.714285714
Cote d'Ivoire,1996,5,2,2,0,100,0,2,0,7,1,50,2.5
Cote d'Ivoire,1997,0,1,1,0,100,0,1,0,0,0,0,0
Cote d'Ivoire,2000,4,2,2,0,100,0,2,0,6,1,50,2
Cote d'Ivoire,2001,12,1,0,1,0,0,1,0,0,1,100,12
Cote d'Ivoire,2002,3,1,1,0,100,0,1,0,0,1,100,3
Cote d'Ivoire,2004,12,1,1,0,100,0,1,0,0,1,100,12
Cote d'Ivoire,2005,41,1,1,0,100,0,1,0,64,1,100,41
Cote d'Ivoire,2006,20,3,3,0,100,0,3,0,12,3,100,6.666666667
Cote d'Ivoire,2007,0,1,1,0,100,0,1,0,2,0,0,0
Cote d'Ivoire,2010,10,7,7,0,100,0,7,0,13,2,28.57142857,1.428571429
Cote d'Ivoire,2011,23,3,3,0,100,0,3,0,3,3,100,7.666666667
Cote d'Ivoire,2012,45,16,15,1,93.75,0,16,0,11,10,62.5,2.8125
Cote d'Ivoire,2013,4,4,4,0,100,0,4,0,3,3,75,1
Cote d'Ivoire,2014,4,1,1,0,100,0,1,0,0,1,100,4
Cote d'Ivoire,2015,14,4,4,0,100,0,4,0,10,3,75,3.5
Cote d'Ivoire,2016,22,1,1,0,100,0,1,0,33,1,100,22
Cote d'Ivoire,2017,3,13,8,5,61.53846154,0,13,0,2,1,7.692307692,0.230769231
Croatia,1991,237,26,26,0,100,0,26,0,35,10,38.46153846,9.115384615
Croatia,1992,2,4,4,0,100,0,4,0,20,1,25,0.5
Croatia,1994,3,4,4,0,100,0,4,0,0,1,25,0.75
Croatia,1995,1,1,1,0,100,1,0,100,2,1,100,1
Croatia,1996,0,3,3,0,100,0,3,0,1,0,0,0
Croatia,1997,2,8,7,1,87.5,0,8,0,2,2,25,0.25
Croatia,2000,3,2,2,0,100,0,2,0,8,2,100,1.5
Croatia,2001,0,3,2,1,66.66666667,0,3,0,0,0,0,0
Croatia,2005,0,1,1,0,100,0,1,0,1,0,0,0
Croatia,2008,0,2,2,0,100,0,2,0,0,0,0,0
Croatia,2009,0,1,1,0,100,0,1,0,3,0,0,0
Croatia,2013,0,2,2,0,100,0,2,0,1,0,0,0
Cuba,1991,0,1,1,0,100,0,1,0,0,0,0,0
Cuba,1992,3,4,4,0,100,0,4,0,1,1,25,0.75
Cuba,1994,3,9,6,3,66.66666667,0,9,0,6,2,22.22222222,0.333333333
Cuba,1996,0,1,1,0,100,0,1,0,0,0,0,0
Cuba,1997,1,14,9,5,64.28571429,0,14,0,3,1,7.142857143,0.071428571
Cuba,2007,1,1,0,1,0,0,1,0,0,1,100,1
Cyprus,1973,1,3,2,1,66.66666667,0,3,0,1,1,33.33333333,0.333333333
Cyprus,1975,0,2,1,1,50,0,2,0,1,0,0,0
Cyprus,1977,0,1,1,0,100,0,1,0,0,0,0,0
Cyprus,1978,16,2,2,0,100,0,2,0,1,1,50,8
Cyprus,1979,2,5,5,0,100,0,5,0,0,1,20,0.4
Cyprus,1980,3,1,0,1,0,0,1,0,0,1,100,3
Cyprus,1981,0,3,2,1,66.66666667,0,3,0,6,0,0,0
Cyprus,1982,0,1,1,0,100,0,1,0,0,0,0,0
Cyprus,1983,0,2,1,1,50,0,2,0,1,0,0,0
Cyprus,1984,6,7,6,1,85.71428571,0,7,0,5,4,57.14285714,0.857142857
Cyprus,1985,3,7,7,0,100,0,7,0,0,3,42.85714286,0.428571429
Cyprus,1986,1,3,3,0,100,0,3,0,2,1,33.33333333,0.333333333
Cyprus,1987,1,10,5,5,50,0,10,0,2,1,10,0.1
Cyprus,1988,6,5,4,1,80,0,5,0,15,2,40,1.2
Cyprus,1989,1,6,5,1,83.33333333,0,6,0,1,1,16.66666667,0.166666667
Cyprus,1990,0,11,10,1,90.90909091,0,11,0,2,0,0,0
Cyprus,1991,0,11,11,0,100,0,11,0,0,0,0,0
Cyprus,1992,0,6,6,0,100,0,6,0,0,0,0,0
Cyprus,1994,2,6,5,1,83.33333333,0,6,0,0,1,16.66666667,0.333333333
Cyprus,1995,0,3,3,0,100,0,3,0,1,0,0,0
Cyprus,1996,3,10,10,0,100,0,10,0,3,3,30,0.3
Cyprus,1998,0,1,1,0,100,0,1,0,0,0,0,0
Cyprus,1999,0,1,1,0,100,0,1,0,0,0,0,0
Cyprus,2000,0,2,2,0,100,0,2,0,0,0,0,0
Cyprus,2001,0,1,0,1,0,0,1,0,0,0,0,0
Cyprus,2004,0,1,1,0,100,0,1,0,0,0,0,0
Cyprus,2007,0,1,1,0,100,0,1,0,0,0,0,0
Cyprus,2012,0,1,0,1,0,0,1,0,0,0,0,0
Cyprus,2013,0,9,8,1,88.88888889,0,9,0,0,0,0,0
Cyprus,2014,0,5,4,1,80,0,5,0,0,0,0,0
Cyprus,2015,0,3,3,0,100,0,3,0,0,0,0,0
Cyprus,2016,0,2,1,1,50,0,2,0,0,0,0,0
Czech Republic,1994,0,1,1,0,100,0,1,0,0,0,0,0
Czech Republic,1995,1,3,1,2,33.33333333,0,3,0,0,1,33.33333333,0.333333333
Czech Republic,1996,2,3,3,0,100,0,3,0,3,1,33.33333333,0.666666667
Czech Republic,1997,1,4,3,1,75,0,4,0,0,1,25,0.25
Czech Republic,2001,0,1,1,0,100,0,1,0,0,0,0,0
Czech Republic,2003,0,1,0,1,0,0,1,0,0,0,0,0
Czech Republic,2008,0,2,1,1,50,0,2,0,20,0,0,0
Czech Republic,2009,0,1,1,0,100,0,1,0,4,0,0,0
Czech Republic,2011,0,1,0,1,0,0,1,0,0,0,0,0
Czech Republic,2013,1,1,1,0,100,1,0,100,0,1,100,1
Czech Republic,2014,1,5,3,2,60,0,5,0,1,1,20,0.2
Czech Republic,2015,0,4,4,0,100,0,4,0,0,0,0,0
Czech Republic,2016,0,2,1,1,50,0,2,0,1,0,0,0
Czech Republic,2017,0,3,3,0,100,0,3,0,0,0,0,0
Czechoslovakia,1972,26,1,1,0,100,0,1,0,0,1,100,26
Czechoslovakia,1989,0,4,3,1,75,0,4,0,0,0,0,0
Czechoslovakia,1990,0,1,1,0,100,0,1,0,20,0,0,0
Czechoslovakia,1991,1,1,1,0,100,0,1,0,0,1,100,1
Czechoslovakia,1992,0,3,1,2,33.33333333,0,3,0,3,0,0,0
Democratic Republic of Congo,1997,8,1,1,0,100,0,1,0,0,1,100,8
Democratic Republic of Congo,1998,67,4,4,0,100,0,4,0,0,2,50,16.75
Democratic Republic of Congo,1999,7,3,2,1,66.66666667,0,3,0,0,2,66.66666667,2.333333333
Democratic Republic of Congo,2000,40,3,3,0,100,0,3,0,9,3,100,13.33333333
Democratic Republic of Congo,2001,15,5,5,0,100,0,5,0,5,2,40,3
Democratic Republic of Congo,2002,16,7,7,0,100,0,7,0,32,4,57.14285714,2.285714286
Democratic Republic of Congo,2003,154,6,6,0,100,0,6,0,1,5,83.33333333,25.66666667
Democratic Republic of Congo,2004,22,5,5,0,100,0,5,0,11,4,80,4.4
Democratic Republic of Congo,2005,31,5,5,0,100,0,5,0,36,5,100,6.2
Democratic Republic of Congo,2006,23,5,5,0,100,0,5,0,1,1,20,4.6
Democratic Republic of Congo,2007,72,11,11,0,100,0,11,0,53,9,81.81818182,6.545454545
Democratic Republic of Congo,2008,319,20,19,1,95,0,20,0,26,13,65,15.95
Democratic Republic of Congo,2009,824,54,53,1,98.14814815,0,54,0,155,37,68.51851852,15.25925926
Democratic Republic of Congo,2010,118,18,18,0,100,0,18,0,12,9,50,6.555555556
Democratic Republic of Congo,2011,50,16,13,3,81.25,0,16,0,8,10,62.5,3.125
Democratic Republic of Congo,2012,288,25,24,1,96,0,25,0,165,18,72,11.52
Democratic Republic of Congo,2013,150,22,22,0,100,0,22,0,72,12,54.54545455,6.818181818
Democratic Republic of Congo,2014,366,110,107,3,97.27272727,0,110,0,170,57,51.81818182,3.327272727
Democratic Republic of Congo,2015,371,143,136,7,95.1048951,0,143,0,244,78,54.54545455,2.594405594
Democratic Republic of Congo,2016,532,169,146,23,86.39053254,0,169,0,176,87,51.47928994,3.147928994
Democratic Republic of Congo,2017,596,143,125,18,87.41258741,0,143,0,193,82,57.34265734,4.167832168
Denmark,1978,0,1,1,0,100,0,1,0,0,0,0,0
Denmark,1979,0,3,1,2,33.33333333,0,3,0,2,0,0,0
Denmark,1980,0,1,1,0,100,0,1,0,0,0,0,0
Denmark,1981,0,6,5,1,83.33333333,0,6,0,6,0,0,0
Denmark,1985,1,4,4,0,100,0,4,0,10,1,25,0.25
Denmark,1986,0,2,1,1,50,0,2,0,0,0,0,0
Denmark,1987,0,2,1,1,50,0,2,0,0,0,0,0
Denmark,1988,0,1,1,0,100,0,1,0,0,0,0,0
Denmark,1989,0,1,1,0,100,0,1,0,0,0,0,0
Denmark,1991,0,1,1,0,100,0,1,0,0,0,0,0
Denmark,1992,1,4,4,0,100,0,4,0,0,1,25,0.25
Denmark,1995,0,6,6,0,100,0,6,0,0,0,0,0
Denmark,1999,0,1,1,0,100,0,1,0,0,0,0,0
Denmark,2008,0,1,1,0,100,0,1,0,2,0,0,0
Denmark,2010,0,1,1,0,100,0,1,0,1,0,0,0
Denmark,2013,0,1,0,1,0,0,1,0,0,0,0,0
Denmark,2015,2,4,4,0,100,0,4,0,5,2,50,0.5
Denmark,2016,1,1,1,0,100,0,1,0,3,1,100,1
Djibouti,1977,1,1,1,0,100,0,1,0,1,1,100,1
Djibouti,1979,4,1,1,0,100,0,1,0,3,1,100,4
Djibouti,1987,10,1,1,0,100,0,1,0,40,1,100,10
Djibouti,1988,0,2,2,0,100,0,2,0,0,0,0,0
Djibouti,1990,1,1,1,0,100,0,1,0,14,1,100,1
Djibouti,1991,8,1,1,0,100,0,1,0,26,1,100,8
Djibouti,1992,228,6,6,0,100,0,6,0,21,4,66.66666667,38
Djibouti,1994,6,2,2,0,100,0,2,0,15,2,100,3
Djibouti,1995,0,2,2,0,100,0,2,0,4,0,0,0
Djibouti,1997,11,1,1,0,100,0,1,0,16,1,100,11
Djibouti,2004,0,1,1,0,100,0,1,0,7,0,0,0
Djibouti,2014,5,1,1,0,100,1,0,100,15,1,100,5
Djibouti,2015,0,1,1,0,100,0,1,0,0,0,0,0
Djibouti,2017,0,1,1,0,100,0,1,0,0,0,0,0
Dominica,1981,3,2,2,0,100,0,2,0,10,1,50,1.5
Dominica,1997,0,1,0,1,0,0,1,0,0,0,0,0
Dominican Republic,1970,1,2,2,0,100,0,2,0,0,1,50,0.5
Dominican Republic,1971,0,3,2,1,66.66666667,0,3,0,0,0,0,0
Dominican Republic,1973,0,3,1,2,33.33333333,0,3,0,0,0,0,0
Dominican Republic,1974,0,2,2,0,100,0,2,0,0,0,0,0
Dominican Republic,1978,3,1,1,0,100,0,1,0,0,1,100,3
Dominican Republic,1979,1,2,2,0,100,0,2,0,1,1,50,0.5
Dominican Republic,1980,1,1,1,0,100,0,1,0,2,1,100,1
Dominican Republic,1982,5,2,2,0,100,0,2,0,3,1,50,2.5
Dominican Republic,1987,7,15,15,0,100,0,15,0,4,7,46.66666667,0.466666667
Dominican Republic,1988,0,2,2,0,100,0,2,0,4,0,0,0
Dominican Republic,1989,1,11,11,0,100,0,11,0,2,1,9.090909091,0.090909091
Dominican Republic,1990,3,2,2,0,100,0,2,0,3,1,50,1.5
Dominican Republic,1991,1,8,8,0,100,0,8,0,0,1,12.5,0.125
Dominican Republic,1992,1,11,11,0,100,0,11,0,10,1,9.090909091,0.090909091
Dominican Republic,1994,2,7,6,1,85.71428571,0,7,0,18,1,14.28571429,0.285714286
Dominican Republic,1996,3,3,3,0,100,0,3,0,11,1,33.33333333,1
Dominican Republic,1997,3,12,12,0,100,0,12,0,30,3,25,0.25
Dominican Republic,2013,0,1,0,1,0,0,1,0,0,0,0,0
Dominican Republic,2014,0,1,1,0,100,0,1,0,35,0,0,0
Dominican Republic,2017,2,1,1,0,100,0,1,0,1,1,100,2
East Asia,1970,0,2,2,0,100,0,2,0,0,0,0,0
East Asia,1971,25,1,1,0,100,0,1,0,0,1,100,25
East Asia,1972,0,0,0,0,0,0,0,0,0,0,,
East Asia,1973,0,2,2,0,100,0,2,0,0,0,0,0
East Asia,1974,1,4,4,0,100,0,4,0,7,1,25,0.25
East Asia,1975,0,12,12,0,100,0,12,0,2,0,0,0
East Asia,1976,2,2,1,1,50,0,2,0,1,1,50,1
East Asia,1977,0,4,4,0,100,0,4,0,0,0,0,0
East Asia,1978,4,35,29,6,82.85714286,0,35,0,53,4,11.42857143,0.114285714
East Asia,1979,5,16,14,2,87.5,0,16,0,2,2,12.5,0.3125
East Asia,1980,0,1,1,0,100,0,1,0,2,0,0,0
East Asia,1981,0,4,3,1,75,0,4,0,25,0,0,0
East Asia,1982,1,3,3,0,100,0,3,0,3,1,33.33333333,0.333333333
East Asia,1983,3,13,11,2,84.61538462,0,13,0,5,2,15.38461538,0.230769231
East Asia,1984,0,15,13,2,86.66666667,0,15,0,11,0,0,0
East Asia,1985,2,10,10,0,100,0,10,0,7,1,10,0.2
East Asia,1986,8,12,12,0,100,0,12,0,31,2,16.66666667,0.666666667
East Asia,1987,1,10,9,1,90,0,10,0,3,1,10,0.1
East Asia,1988,0,24,19,5,79.16666667,0,24,0,26,0,0,0
East Asia,1989,22,18,12,6,66.66666667,0,18,0,13,3,16.66666667,1.222222222
East Asia,1990,4,99,89,10,89.8989899,0,99,0,136,3,3.03030303,0.04040404
East Asia,1991,8,29,24,5,82.75862069,0,29,0,31,3,10.34482759,0.275862069
East Asia,1992,27,74,58,16,78.37837838,0,74,0,50,7,9.459459459,0.364864865
East Asia,1994,34,34,26,8,76.47058824,0,34,0,612,11,32.35294118,1
East Asia,1995,21,38,28,10,73.68421053,0,38,0,6426,6,15.78947368,0.552631579
East Asia,1996,32,89,83,6,93.25842697,0,89,0,161,10,11.23595506,0.359550562
East Asia,1997,38,40,33,7,82.5,1,39,2.5,118,8,20,0.95
East Asia,1998,50,9,9,0,100,0,9,0,166,1,11.11111111,5.555555556
East Asia,1999,5,4,4,0,100,0,4,0,50,2,50,1.25
East Asia,2000,1,19,6,13,31.57894737,1,18,5.263157895,19,1,5.263157895,0.052631579
East Asia,2001,9,19,16,3,84.21052632,1,18,5.263157895,57,6,31.57894737,0.473684211
East Asia,2002,1,4,3,1,75,1,3,25,18,1,25,0.25
East Asia,2003,1,6,6,0,100,0,6,0,76,1,16.66666667,0.166666667
East Asia,2004,4,4,3,1,75,1,3,25,7,2,50,1
East Asia,2005,12,2,2,0,100,0,2,0,3,1,50,6
East Asia,2006,0,1,1,0,100,0,1,0,1,0,0,0
East Asia,2007,0,0,0,0,0,0,0,0,0,0,,
East Asia,2008,39,25,21,4,84,2,23,8,197,13,52,1.56
East Asia,2009,186,8,8,0,100,1,7,12.5,56,3,37.5,23.25
East Asia,2010,7,1,1,0,100,0,1,0,14,1,100,7
East Asia,2011,19,4,4,0,100,0,4,0,32,2,50,4.75
East Asia,2012,27,4,3,1,75,2,2,50,38,3,75,6.75
East Asia,2013,60,15,13,2,86.66666667,0,15,0,71,10,66.66666667,4
East Asia,2014,322,43,38,5,88.37209302,3,40,6.976744186,478,25,58.13953488,7.488372093
East Asia,2015,123,28,24,4,85.71428571,3,25,10.71428571,84,13,46.42857143,4.392857143
East Asia,2016,32,8,8,0,100,0,8,0,44,3,37.5,4
East Asia,2017,16,7,7,0,100,1,6,14.28571429,77,2,28.57142857,2.285714286
East Germany (GDR),1970,0,12,12,0,100,0,12,0,0,0,0,0
East Germany (GDR),1971,0,4,3,1,75,0,4,0,0,0,0,0
East Germany (GDR),1974,1,1,1,0,100,0,1,0,0,1,100,1
East Germany (GDR),1977,0,1,1,0,100,0,1,0,0,0,0,0
East Germany (GDR),1978,0,1,1,0,100,0,1,0,1,0,0,0
East Germany (GDR),1982,0,1,1,0,100,0,1,0,0,0,0,0
East Germany (GDR),1983,0,1,1,0,100,0,1,0,0,0,0,0
East Germany (GDR),1984,0,1,1,0,100,0,1,0,1,0,0,0
East Germany (GDR),1985,0,4,4,0,100,0,4,0,0,0,0,0
East Germany (GDR),1986,1,3,3,0,100,0,3,0,34,1,33.33333333,0.333333333
East Germany (GDR),1987,0,1,0,1,0,0,1,0,1,0,0,0
East Germany (GDR),1988,0,4,4,0,100,0,4,0,0,0,0,0
East Germany (GDR),1989,0,1,0,1,0,0,1,0,0,0,0,0
East Germany (GDR),1990,0,3,3,0,100,0,3,0,0,0,0,0
East Timor,2000,1,4,3,1,75,0,4,0,1,1,25,0.25
East Timor,2003,5,2,2,0,100,0,2,0,5,2,100,2.5
East Timor,2005,0,1,0,1,0,0,1,0,0,0,0,0
East Timor,2007,1,2,2,0,100,0,2,0,0,1,50,0.5
East Timor,2008,2,1,0,1,0,0,1,0,1,1,100,2
Eastern Europe,1970,0,12,12,0,100,0,12,0,0,0,0,0
Eastern Europe,1971,0,5,4,1,80,0,5,0,0,0,0,0
Eastern Europe,1972,26,1,1,0,100,0,1,0,0,1,100,26
Eastern Europe,1973,1,1,1,0,100,0,1,0,7,1,100,1
Eastern Europe,1974,1,2,2,0,100,0,2,0,0,1,50,0.5
Eastern Europe,1975,0,0,0,0,0,0,0,0,0,0,,
Eastern Europe,1976,0,0,0,0,0,0,0,0,0,0,,
Eastern Europe,1977,1,2,2,0,100,0,2,0,7,1,50,0.5
Eastern Europe,1978,4,2,2,0,100,0,2,0,1,1,50,2
Eastern Europe,1979,0,1,1,0,100,0,1,0,5,0,0,0
Eastern Europe,1980,0,1,1,0,100,0,1,0,2,0,0,0
Eastern Europe,1981,0,4,3,1,75,0,4,0,5,0,0,0
Eastern Europe,1982,2,3,3,0,100,0,3,0,0,2,66.66666667,0.666666667
Eastern Europe,1983,2,2,2,0,100,0,2,0,4,1,50,1
Eastern Europe,1984,3,4,3,1,75,0,4,0,2,2,50,0.75
Eastern Europe,1985,2,5,5,0,100,0,5,0,0,1,20,0.4
Eastern Europe,1986,1,3,3,0,100,0,3,0,34,1,33.33333333,0.333333333
Eastern Europe,1987,0,1,0,1,0,0,1,0,1,0,0,0
Eastern Europe,1988,0,4,4,0,100,0,4,0,0,0,0,0
Eastern Europe,1989,6,16,12,4,75,0,16,0,27,2,12.5,0.375
Eastern Europe,1990,59,58,52,6,89.65517241,0,58,0,122,17,29.31034483,1.017241379
Eastern Europe,1991,273,84,75,9,89.28571429,0,84,0,72,23,27.38095238,3.25
Eastern Europe,1992,110,91,83,8,91.20879121,0,91,0,174,31,34.06593407,1.208791209
Eastern Europe,1994,49,95,71,24,74.73684211,0,95,0,46,28,29.47368421,0.515789474
Eastern Europe,1995,158,68,50,18,73.52941176,1,67,1.470588235,61,27,39.70588235,2.323529412
Eastern Europe,1996,167,175,154,21,88,0,175,0,219,51,29.14285714,0.954285714
Eastern Europe,1997,115,248,222,26,89.51612903,0,248,0,291,64,25.80645161,0.463709677
Eastern Europe,1998,109,105,92,13,87.61904762,0,105,0,164,32,30.47619048,1.038095238
Eastern Europe,1999,440,138,116,22,84.05797101,0,138,0,979,44,31.88405797,3.188405797
Eastern Europe,2000,402,234,198,36,84.61538462,10,224,4.273504274,710,107,45.72649573,1.717948718
Eastern Europe,2001,294,252,212,40,84.12698413,2,250,0.793650794,558,101,40.07936508,1.166666667
Eastern Europe,2002,518,112,103,9,91.96428571,3,109,2.678571429,464,59,52.67857143,4.625
Eastern Europe,2003,337,100,81,19,81,10,90,10,822,49,49,3.37
Eastern Europe,2004,608,46,37,9,80.43478261,8,38,17.39130435,1176,26,56.52173913,13.2173913
Eastern Europe,2005,158,76,66,10,86.84210526,0,76,0,352,35,46.05263158,2.078947368
Eastern Europe,2006,59,70,65,5,92.85714286,2,68,2.857142857,75,24,34.28571429,0.842857143
Eastern Europe,2007,57,62,58,4,93.5483871,2,60,3.225806452,144,28,45.16129032,0.919354839
Eastern Europe,2008,101,209,170,39,81.33971292,1,208,0.4784689,332,57,27.27272727,0.483253589
Eastern Europe,2009,143,165,136,29,82.42424242,5,160,3.03030303,275,67,40.60606061,0.866666667
Eastern Europe,2010,235,261,223,38,85.44061303,11,250,4.214559387,639,100,38.31417625,0.900383142
Eastern Europe,2011,174,198,169,29,85.35353535,6,192,3.03030303,595,78,39.39393939,0.878787879
Eastern Europe,2012,179,173,137,36,79.19075145,9,164,5.202312139,332,74,42.77456647,1.034682081
Eastern Europe,2013,151,165,130,35,78.78787879,11,154,6.666666667,296,71,43.03030303,0.915151515
Eastern Europe,2014,1467,962,858,104,89.18918919,2,960,0.207900208,1329,243,25.25987526,1.524948025
Eastern Europe,2015,790,684,624,60,91.22807018,0,684,0,1433,158,23.0994152,1.15497076
Eastern Europe,2016,112,134,99,35,73.88059701,4,130,2.985074627,107,38,28.35820896,0.835820896
Eastern Europe,2017,101,110,95,15,86.36363636,5,105,4.545454545,183,34,30.90909091,0.918181818
Ecuador,1973,0,1,1,0,100,0,1,0,0,0,0,0
Ecuador,1974,0,3,2,1,66.66666667,0,3,0,2,0,0,0
Ecuador,1976,1,2,1,1,50,0,2,0,1,1,50,0.5
Ecuador,1977,1,7,7,0,100,0,7,0,0,1,14.28571429,0.142857143
Ecuador,1978,2,11,11,0,100,0,11,0,9,2,18.18181818,0.181818182
Ecuador,1979,0,2,2,0,100,0,2,0,0,0,0,0
Ecuador,1980,2,2,2,0,100,0,2,0,6,1,50,1
Ecuador,1981,2,2,2,0,100,0,2,0,2,1,50,1
Ecuador,1982,1,3,3,0,100,0,3,0,1,1,33.33333333,0.333333333
Ecuador,1983,0,10,9,1,90,0,10,0,0,0,0,0
Ecuador,1984,1,24,23,1,95.83333333,0,24,0,2,1,4.166666667,0.041666667
Ecuador,1985,4,12,11,1,91.66666667,0,12,0,2,4,33.33333333,0.333333333
Ecuador,1986,13,8,8,0,100,0,8,0,0,6,75,1.625
Ecuador,1987,0,6,6,0,100,0,6,0,1,0,0,0
Ecuador,1988,4,9,8,1,88.88888889,0,9,0,7,3,33.33333333,0.444444444
Ecuador,1989,9,14,14,0,100,0,14,0,2,5,35.71428571,0.642857143
Ecuador,1990,3,8,8,0,100,0,8,0,6,1,12.5,0.375
Ecuador,1991,0,17,16,1,94.11764706,0,17,0,0,0,0,0
Ecuador,1992,2,23,20,3,86.95652174,0,23,0,6,2,8.695652174,0.086956522
Ecuador,1994,0,6,6,0,100,0,6,0,2,0,0,0
Ecuador,1995,4,6,5,1,83.33333333,0,6,0,2,2,33.33333333,0.666666667
Ecuador,1996,2,5,4,1,80,0,5,0,2,2,40,0.4
Ecuador,1997,1,4,4,0,100,0,4,0,0,1,25,0.25
Ecuador,1998,0,3,3,0,100,0,3,0,1,0,0,0
Ecuador,1999,0,2,2,0,100,0,2,0,0,0,0,0
Ecuador,2000,0,4,3,1,75,0,4,0,1,0,0,0
Ecuador,2001,0,5,5,0,100,0,5,0,0,0,0,0
Ecuador,2002,0,2,2,0,100,0,2,0,3,0,0,0
Ecuador,2003,0,4,4,0,100,0,4,0,4,0,0,0
Ecuador,2004,0,2,1,1,50,0,2,0,0,0,0,0
Ecuador,2008,0,2,2,0,100,0,2,0,3,0,0,0
Ecuador,2009,0,1,1,0,100,0,1,0,0,0,0,0
Ecuador,2011,0,1,1,0,100,0,1,0,0,0,0,0
Ecuador,2012,0,1,1,0,100,0,1,0,0,0,0,0
Ecuador,2013,1,2,1,1,50,0,2,0,0,1,50,0.5
Ecuador,2015,0,1,1,0,100,0,1,0,0,0,0,0
Ecuador,2016,1,2,2,0,100,0,2,0,14,1,50,0.5
Ecuador,2017,0,3,1,2,33.33333333,0,3,0,0,0,0,0
Egypt,1970,0,1,1,0,100,0,1,0,2,0,0,0
Egypt,1971,1,1,1,0,100,0,1,0,0,1,100,1
Egypt,1972,0,1,0,1,0,0,1,0,0,0,0,0
Egypt,1977,1,1,1,0,100,0,1,0,0,1,100,1
Egypt,1978,2,2,2,0,100,0,2,0,0,1,50,1
Egypt,1979,1,1,1,0,100,0,1,0,4,1,100,1
Egypt,1980,1,5,3,2,60,0,5,0,10,1,20,0.2
Egypt,1981,67,9,4,5,44.44444444,0,9,0,89,4,44.44444444,7.444444444
Egypt,1982,0,1,1,0,100,0,1,0,3,0,0,0
Egypt,1985,2,2,2,0,100,0,2,0,2,2,100,1
Egypt,1986,12,4,3,1,75,0,4,0,21,3,75,3
Egypt,1987,1,7,5,2,71.42857143,0,7,0,12,1,14.28571429,0.142857143
Egypt,1988,1,9,7,2,77.77777778,0,9,0,17,1,11.11111111,0.111111111
Egypt,1989,1,7,4,3,57.14285714,0,7,0,1,1,14.28571429,0.142857143
Egypt,1990,21,13,10,3,76.92307692,0,13,0,32,6,46.15384615,1.615384615
Egypt,1991,8,10,8,2,80,0,10,0,13,5,50,0.8
Egypt,1992,49,79,67,12,84.81012658,0,79,0,121,27,34.17721519,0.620253165
Egypt,1994,173,143,122,21,85.31468531,0,143,0,148,93,65.03496503,1.20979021
Egypt,1995,134,102,97,5,95.09803922,0,102,0,135,81,79.41176471,1.31372549
Egypt,1996,97,51,49,2,96.07843137,0,51,0,63,43,84.31372549,1.901960784
Egypt,1997,165,22,22,0,100,0,22,0,47,22,100,7.5
Egypt,1998,9,3,3,0,100,0,3,0,15,3,100,3
Egypt,1999,1,1,0,1,0,0,1,0,1,1,100,1
Egypt,2004,37,3,3,0,100,3,0,100,171,3,100,12.33333333
Egypt,2005,92,2,2,0,100,2,0,100,117,2,100,46
Egypt,2006,19,5,4,1,80,0,5,0,100,2,40,3.8
Egypt,2008,0,1,1,0,100,0,1,0,0,0,0,0
Egypt,2009,1,2,2,0,100,0,2,0,25,1,50,0.5
Egypt,2010,0,2,2,0,100,0,2,0,0,0,0,0
Egypt,2011,28,18,18,0,100,2,16,11.11111111,109,4,22.22222222,1.555555556
Egypt,2012,44,49,36,13,73.46938776,0,49,0,87,8,16.32653061,0.897959184
Egypt,2013,243,321,275,46,85.66978193,9,312,2.803738318,623,110,34.26791277,0.757009346
Egypt,2014,343,354,298,56,84.18079096,5,349,1.412429379,548,136,38.4180791,0.968926554
Egypt,2015,829,647,488,159,75.42503864,16,631,2.472952087,1047,225,34.77588872,1.2812983
Egypt,2016,609,376,281,95,74.73404255,9,367,2.393617021,633,194,51.59574468,1.619680851
Egypt,2017,877,224,188,36,83.92857143,16,208,7.142857143,626,140,62.5,3.915178571
El Salvador,1972,0,2,2,0,100,0,2,0,0,0,0,0
El Salvador,1973,0,1,1,0,100,0,1,0,0,0,0,0
El Salvador,1974,0,3,3,0,100,0,3,0,3,0,0,0
El Salvador,1975,2,3,3,0,100,0,3,0,0,1,33.33333333,0.666666667
El Salvador,1976,3,13,13,0,100,0,13,0,1,3,23.07692308,0.230769231
El Salvador,1977,4,6,6,0,100,0,6,0,0,3,50,0.666666667
El Salvador,1978,33,91,87,4,95.6043956,0,91,0,37,19,20.87912088,0.362637363
El Salvador,1979,286,326,313,13,96.01226994,0,326,0,93,115,35.27607362,0.877300613
El Salvador,1980,2383,710,696,14,98.02816901,0,710,0,277,328,46.1971831,3.356338028
El Salvador,1981,1578,664,651,13,98.04216867,0,664,0,359,196,29.51807229,2.376506024
El Salvador,1982,1549,537,533,4,99.25512104,0,537,0,193,143,26.62942272,2.884543762
El Salvador,1983,1667,371,369,2,99.46091644,0,371,0,458,106,28.57142857,4.493261456
El Salvador,1984,1315,273,270,3,98.9010989,0,273,0,487,110,40.29304029,4.816849817
El Salvador,1985,1013,436,435,1,99.7706422,0,436,0,279,134,30.73394495,2.323394495
El Salvador,1986,293,175,173,2,98.85714286,0,175,0,187,46,26.28571429,1.674285714
El Salvador,1987,421,234,229,5,97.86324786,0,234,0,317,54,23.07692308,1.799145299
El Salvador,1988,361,367,362,5,98.63760218,0,367,0,364,80,21.79836512,0.983651226
El Salvador,1989,350,356,343,13,96.34831461,0,356,0,612,99,27.80898876,0.983146067
El Salvador,1990,294,184,180,4,97.82608696,0,184,0,224,33,17.93478261,1.597826087
El Salvador,1991,426,500,497,3,99.4,0,500,0,1017,99,19.8,0.852
El Salvador,1992,23,29,27,2,93.10344828,0,29,0,38,13,44.82758621,0.793103448
El Salvador,1994,22,21,16,5,76.19047619,0,21,0,32,11,52.38095238,1.047619048
El Salvador,1995,3,9,9,0,100,0,9,0,16,2,22.22222222,0.333333333
El Salvador,1996,26,7,7,0,100,0,7,0,59,6,85.71428571,3.714285714
El Salvador,1997,1,2,2,0,100,0,2,0,9,1,50,0.5
Equatorial Guinea,1992,1,1,1,0,100,0,1,0,0,1,100,1
Equatorial Guinea,2009,1,1,1,0,100,0,1,0,3,1,100,1
Eritrea,1995,0,2,2,0,100,0,2,0,19,0,0,0
Eritrea,1996,6,1,1,0,100,0,1,0,0,1,100,6
Eritrea,2007,0,2,2,0,100,0,2,0,0,0,0,0
Eritrea,2008,4,2,2,0,100,0,2,0,10,1,50,2
Eritrea,2009,2,1,1,0,100,0,1,0,8,1,100,2
Eritrea,2010,17,1,1,0,100,0,1,0,20,1,100,17
Eritrea,2011,17,1,1,0,100,0,1,0,5,1,100,17
Estonia,1992,0,2,2,0,100,0,2,0,1,0,0,0
Estonia,1994,0,6,6,0,100,0,6,0,0,0,0,0
Estonia,1995,0,2,2,0,100,0,2,0,0,0,0,0
Estonia,1996,1,1,1,0,100,0,1,0,10,1,100,1
Estonia,1999,0,1,1,0,100,0,1,0,0,0,0,0
Estonia,2001,1,1,1,0,100,0,1,0,0,1,100,1
Estonia,2011,1,1,1,0,100,0,1,0,0,1,100,1
Estonia,2015,0,2,2,0,100,0,2,0,0,0,0,0
Ethiopia,1970,1,3,3,0,100,0,3,0,0,1,33.33333333,0.333333333
Ethiopia,1971,0,1,1,0,100,0,1,0,0,0,0,0
Ethiopia,1973,0,1,1,0,100,0,1,0,0,0,0,0
Ethiopia,1974,3,4,4,0,100,0,4,0,0,2,50,0.75
Ethiopia,1975,0,4,4,0,100,0,4,0,0,0,0,0
Ethiopia,1976,0,5,5,0,100,0,5,0,0,0,0,0
Ethiopia,1977,5,4,4,0,100,0,4,0,0,3,75,1.25
Ethiopia,1978,25,2,2,0,100,0,2,0,0,1,50,12.5
Ethiopia,1979,101,4,4,0,100,0,4,0,8,2,50,25.25
Ethiopia,1983,0,3,3,0,100,0,3,0,0,0,0,0
Ethiopia,1984,200,1,1,0,100,0,1,0,200,1,100,200
Ethiopia,1985,0,1,1,0,100,0,1,0,0,0,0,0
Ethiopia,1986,40,1,1,0,100,0,1,0,0,1,100,40
Ethiopia,1987,0,1,1,0,100,0,1,0,0,0,0,0
Ethiopia,1988,0,2,2,0,100,0,2,0,0,0,0,0
Ethiopia,1989,1,1,1,0,100,0,1,0,0,1,100,1
Ethiopia,1990,17,10,10,0,100,0,10,0,0,1,10,1.7
Ethiopia,1991,161,5,5,0,100,0,5,0,0,2,40,32.2
Ethiopia,1992,330,13,13,0,100,0,13,0,332,6,46.15384615,25.38461538
Ethiopia,1994,6,4,3,1,75,0,4,0,1,2,50,1.5
Ethiopia,1995,5,5,4,1,80,0,5,0,4,3,60,1
Ethiopia,1996,133,7,6,1,85.71428571,0,7,0,27,7,100,19
Ethiopia,1997,8,6,6,0,100,0,6,0,135,5,83.33333333,1.333333333
Ethiopia,1999,2,2,2,0,100,0,2,0,2,1,50,1
Ethiopia,2000,3,1,1,0,100,0,1,0,0,1,100,3
Ethiopia,2002,1,3,3,0,100,0,3,0,37,1,33.33333333,0.333333333
Ethiopia,2003,2,1,1,0,100,0,1,0,9,1,100,2
Ethiopia,2004,1,2,2,0,100,0,2,0,16,1,50,0.5
Ethiopia,2005,9,5,4,1,80,0,5,0,37,4,80,1.8
Ethiopia,2006,12,11,8,3,72.72727273,0,11,0,56,2,18.18181818,1.090909091
Ethiopia,2007,204,5,5,0,100,0,5,0,52,4,80,40.8
Ethiopia,2008,27,8,8,0,100,0,8,0,82,6,75,3.375
Ethiopia,2009,13,2,2,0,100,0,2,0,0,1,50,6.5
Ethiopia,2010,8,2,2,0,100,0,2,0,20,2,100,4
Ethiopia,2011,2,3,3,0,100,0,3,0,3,2,66.66666667,0.666666667
Ethiopia,2012,25,3,3,0,100,0,3,0,8,3,100,8.333333333
Ethiopia,2013,17,5,4,1,80,1,4,20,0,4,80,3.4
Ethiopia,2014,9,2,2,0,100,0,2,0,6,1,50,4.5
Ethiopia,2015,48,7,7,0,100,0,7,0,43,5,71.42857143,6.857142857
Ethiopia,2016,279,13,13,0,100,0,13,0,83,12,92.30769231,21.46153846
Ethiopia,2017,67,27,26,1,96.2962963,0,27,0,53,13,48.14814815,2.481481481
Falkland Islands,1983,0,1,1,0,100,0,1,0,0,0,0,0
Fiji,1987,0,3,3,0,100,0,3,0,1,0,0,0
Fiji,1989,0,2,2,0,100,0,2,0,0,0,0,0
Fiji,1991,0,3,3,0,100,0,3,0,0,0,0,0
Fiji,1992,1,1,1,0,100,0,1,0,0,1,100,1
Fiji,1999,0,3,3,0,100,0,3,0,0,0,0,0
Fiji,2000,7,4,3,1,75,0,4,0,17,1,25,1.75
Fiji,2001,0,1,1,0,100,0,1,0,0,0,0,0
Finland,1986,0,1,1,0,100,0,1,0,1,0,0,0
Finland,1992,0,1,1,0,100,0,1,0,0,0,0,0
Finland,1994,0,1,1,0,100,0,1,0,0,0,0,0
Finland,1995,0,1,1,0,100,0,1,0,1,0,0,0
Finland,2007,9,1,1,0,100,1,0,100,13,1,100,9
Finland,2008,0,1,1,0,100,0,1,0,1,0,0,0
Finland,2015,0,9,8,1,88.88888889,0,9,0,1,0,0,0
Finland,2016,0,3,3,0,100,0,3,0,0,0,0,0
Finland,2017,2,2,2,0,100,0,2,0,10,1,50,1
France,1972,1,11,7,4,63.63636364,0,11,0,0,1,9.090909091,0.090909091
France,1973,5,14,12,2,85.71428571,0,14,0,20,3,21.42857143,0.357142857
France,1974,3,29,27,2,93.10344828,0,29,0,41,2,6.896551724,0.103448276
France,1975,3,39,37,2,94.87179487,0,39,0,25,2,5.128205128,0.076923077
France,1976,7,58,56,2,96.55172414,0,58,0,10,7,12.06896552,0.120689655
France,1977,3,53,51,2,96.22641509,0,53,0,7,3,5.660377358,0.056603774
France,1978,21,59,56,3,94.91525424,0,59,0,17,7,11.86440678,0.355932203
France,1979,11,212,204,8,96.22641509,0,212,0,41,11,5.188679245,0.051886792
France,1980,20,94,83,11,88.29787234,0,94,0,74,12,12.76595745,0.212765957
France,1981,8,66,53,13,80.3030303,0,66,0,78,7,10.60606061,0.121212121
France,1982,17,62,55,7,88.70967742,0,62,0,144,8,12.90322581,0.274193548
France,1983,20,121,111,10,91.73553719,0,121,0,186,9,7.438016529,0.165289256
France,1984,15,145,139,6,95.86206897,0,145,0,57,11,7.586206897,0.103448276
France,1985,17,106,103,3,97.16981132,0,106,0,83,11,10.37735849,0.160377358
France,1986,25,95,84,11,88.42105263,0,95,0,306,14,14.73684211,0.263157895
France,1987,5,87,85,2,97.70114943,0,87,0,8,4,4.597701149,0.057471264
France,1988,6,54,54,0,100,0,54,0,19,6,11.11111111,0.111111111
France,1989,3,25,24,1,96,0,25,0,2,3,12,0.12
France,1990,3,30,28,2,93.33333333,0,30,0,3,3,10,0.1
France,1991,6,137,131,6,95.62043796,0,137,0,5,4,2.919708029,0.04379562
France,1992,9,126,116,10,92.06349206,0,126,0,12,8,6.349206349,0.071428571
France,1994,7,97,93,4,95.87628866,0,97,0,22,4,4.12371134,0.072164948
France,1995,19,71,67,4,94.36619718,0,71,0,177,11,15.49295775,0.267605634
France,1996,18,270,232,38,85.92592593,0,270,0,114,13,4.814814815,0.066666667
France,1997,0,130,126,4,96.92307692,0,130,0,4,0,0,0
France,1998,1,12,11,1,91.66666667,0,12,0,0,1,8.333333333,0.083333333
France,1999,0,46,44,2,95.65217391,0,46,0,2,0,0,0
France,2000,4,28,24,4,85.71428571,0,28,0,1,3,10.71428571,0.142857143
France,2001,0,21,16,5,76.19047619,1,20,4.761904762,16,0,0,0
France,2002,0,32,28,4,87.5,0,32,0,4,0,0,0
France,2003,0,34,31,3,91.17647059,0,34,0,21,0,0,0
France,2004,0,11,9,2,81.81818182,0,11,0,10,0,0,0
France,2005,0,33,32,1,96.96969697,0,33,0,11,0,0,0
France,2006,1,34,27,7,79.41176471,0,34,0,3,1,2.941176471,0.029411765
France,2007,3,16,14,2,87.5,0,16,0,8,2,12.5,0.1875
France,2008,0,13,7,6,53.84615385,0,13,0,1,0,0,0
France,2009,0,9,8,1,88.88888889,0,9,0,11,0,0,0
France,2010,0,3,3,0,100,0,3,0,0,0,0,0
France,2011,0,8,6,2,75,0,8,0,4,0,0,0
France,2012,8,66,66,0,100,0,66,0,8,3,4.545454545,0.121212121
France,2013,0,18,15,3,83.33333333,0,18,0,5,0,0,0
France,2014,1,14,14,0,100,0,14,0,15,1,7.142857143,0.071428571
France,2015,162,37,35,2,94.59459459,5,32,13.51351351,443,15,40.54054054,4.378378378
France,2016,95,26,23,3,88.46153846,0,26,0,470,5,19.23076923,3.653846154
France,2017,7,41,34,7,82.92682927,1,40,2.43902439,28,4,9.756097561,0.170731707
French Guiana,1983,1,3,3,0,100,0,3,0,0,1,33.33333333,0.333333333
French Guiana,1996,0,2,2,0,100,0,2,0,1,0,0,0
French Guiana,1997,0,2,1,1,50,0,2,0,12,0,0,0
French Polynesia,1995,0,3,3,0,100,0,3,0,13,0,0,0
Gabon,1979,2,1,1,0,100,0,1,0,0,1,100,2
Gabon,1994,0,1,1,0,100,0,1,0,0,0,0,0
Gabon,1996,0,1,0,1,0,0,1,0,1,0,0,0
Gabon,1997,4,1,1,0,100,0,1,0,0,1,100,4
Gabon,2017,0,4,3,1,75,0,4,0,2,0,0,0
Gambia,1994,13,1,0,1,0,0,1,0,0,1,100,13
Gambia,1995,0,1,0,1,0,0,1,0,0,0,0,0
Gambia,2000,0,1,1,0,100,0,1,0,2,0,0,0
Georgia,1991,2,3,3,0,100,0,3,0,8,1,33.33333333,0.666666667
Georgia,1992,109,39,38,1,97.43589744,0,39,0,50,19,48.71794872,2.794871795
Georgia,1994,29,18,15,3,83.33333333,0,18,0,45,10,55.55555556,1.611111111
Georgia,1995,14,17,15,2,88.23529412,0,17,0,23,9,52.94117647,0.823529412
Georgia,1996,2,3,3,0,100,0,3,0,10,2,66.66666667,0.666666667
Georgia,1997,35,6,6,0,100,0,6,0,3,5,83.33333333,5.833333333
Georgia,1998,32,12,11,1,91.66666667,0,12,0,47,10,83.33333333,2.666666667
Georgia,1999,5,7,7,0,100,0,7,0,26,2,28.57142857,0.714285714
Georgia,2000,3,7,7,0,100,0,7,0,5,2,28.57142857,0.428571429
Georgia,2001,6,4,4,0,100,0,4,0,9,3,75,1.5
Georgia,2002,1,2,2,0,100,0,2,0,15,1,50,0.5
Georgia,2003,0,6,6,0,100,0,6,0,1,0,0,0
Georgia,2004,0,3,0,3,0,0,3,0,1,0,0,0
Georgia,2005,8,6,4,2,66.66666667,0,6,0,32,2,33.33333333,1.333333333
Georgia,2006,5,3,3,0,100,0,3,0,4,3,100,1.666666667
Georgia,2008,13,33,30,3,90.90909091,0,33,0,62,7,21.21212121,0.393939394
Georgia,2009,5,25,24,1,96,0,25,0,21,4,16,0.2
Georgia,2010,4,7,6,1,85.71428571,0,7,0,14,3,42.85714286,0.571428571
Georgia,2011,1,3,2,1,66.66666667,0,3,0,1,1,33.33333333,0.333333333
Georgia,2012,1,3,0,3,0,0,3,0,2,1,33.33333333,0.333333333
Georgia,2013,2,2,2,0,100,0,2,0,0,1,50,1
Georgia,2014,0,2,1,1,50,0,2,0,1,0,0,0
Georgia,2015,0,1,0,1,0,0,1,0,0,0,0,0
Georgia,2016,1,4,3,1,75,0,4,0,7,1,25,0.25
Georgia,2017,0,1,0,1,0,0,1,0,5,0,0,0
Germany,1990,0,1,1,0,100,0,1,0,0,0,0,0
Germany,1991,10,65,51,14,78.46153846,0,65,0,35,6,9.230769231,0.153846154
Germany,1992,17,156,149,7,95.51282051,0,156,0,217,10,6.41025641,0.108974359
Germany,1994,2,79,75,4,94.93670886,0,79,0,85,1,1.265822785,0.025316456
Germany,1995,10,147,135,12,91.83673469,0,147,0,26,6,4.081632653,0.068027211
Germany,1996,1,52,47,5,90.38461538,0,52,0,5,1,1.923076923,0.019230769
Germany,1997,0,12,12,0,100,0,12,0,27,0,0,0
Germany,1998,0,6,3,3,50,0,6,0,0,0,0,0
Germany,1999,3,13,11,2,84.61538462,0,13,0,47,1,7.692307692,0.230769231
Germany,2000,1,8,7,1,87.5,0,8,0,29,1,12.5,0.125
Germany,2001,3,8,8,0,100,0,8,0,6,3,37.5,0.375
Germany,2002,0,3,3,0,100,0,3,0,2,0,0,0
Germany,2003,0,2,1,1,50,0,2,0,0,0,0,0
Germany,2004,1,3,3,0,100,0,3,0,25,1,33.33333333,0.333333333
Germany,2005,2,3,3,0,100,0,3,0,0,2,66.66666667,0.666666667
Germany,2006,2,4,3,1,75,0,4,0,0,2,50,0.5
Germany,2007,1,3,3,0,100,0,3,0,1,1,33.33333333,0.333333333
Germany,2008,0,3,3,0,100,0,3,0,2,0,0,0
Germany,2009,0,4,4,0,100,0,4,0,0,0,0,0
Germany,2010,0,1,0,1,0,0,1,0,0,0,0,0
Germany,2011,2,8,2,6,25,0,8,0,2,1,12.5,0.25
Germany,2012,0,5,3,2,60,0,5,0,0,0,0,0
Germany,2014,0,13,11,2,84.61538462,0,13,0,0,0,0,0
Germany,2015,1,65,59,6,90.76923077,0,65,0,47,1,1.538461538,0.015384615
Germany,2016,27,44,41,3,93.18181818,0,44,0,117,7,15.90909091,0.613636364
Germany,2017,1,27,21,6,77.77777778,1,26,3.703703704,10,1,3.703703704,0.037037037
Ghana,1987,0,1,1,0,100,0,1,0,0,0,0,0
Ghana,1992,0,8,7,1,87.5,0,8,0,1,0,0,0
Ghana,1994,13,4,3,1,75,0,4,0,0,3,75,3.25
Ghana,1995,2,1,1,0,100,0,1,0,6,1,100,2
Ghana,1996,3,2,2,0,100,0,2,0,0,2,100,1.5
Ghana,1997,1,1,1,0,100,0,1,0,3,1,100,1
Ghana,2014,0,1,0,1,0,0,1,0,3,0,0,0
Ghana,2016,0,1,0,1,0,0,1,0,0,0,0,0
Greece,1970,2,3,3,0,100,0,3,0,0,1,33.33333333,0.666666667
Greece,1971,0,1,1,0,100,0,1,0,0,0,0,0
Greece,1972,0,2,2,0,100,0,2,0,0,0,0,0
Greece,1973,5,11,10,1,90.90909091,0,11,0,55,1,9.090909091,0.454545455
Greece,1974,92,6,3,3,50,0,6,0,0,3,50,15.33333333
Greece,1975,1,4,4,0,100,0,4,0,0,1,25,0.25
Greece,1976,14,21,20,1,95.23809524,0,21,0,1,2,9.523809524,0.666666667
Greece,1977,1,47,45,2,95.74468085,0,47,0,1,1,2.127659574,0.021276596
Greece,1978,0,39,39,0,100,0,39,0,4,0,0,0
Greece,1979,1,9,9,0,100,0,9,0,5,1,11.11111111,0.111111111
Greece,1980,5,15,13,2,86.66666667,0,15,0,2,3,20,0.333333333
Greece,1981,3,20,18,2,90,0,20,0,74,2,10,0.15
Greece,1982,2,19,15,4,78.94736842,0,19,0,0,2,10.52631579,0.105263158
Greece,1983,4,11,11,0,100,0,11,0,6,3,27.27272727,0.363636364
Greece,1984,5,28,21,7,75,0,28,0,89,4,14.28571429,0.178571429
Greece,1985,64,35,30,5,85.71428571,0,35,0,170,5,14.28571429,1.828571429
Greece,1986,6,41,37,4,90.24390244,0,41,0,14,3,7.317073171,0.146341463
Greece,1987,2,26,21,5,80.76923077,0,26,0,37,2,7.692307692,0.076923077
Greece,1988,14,38,34,4,89.47368421,0,38,0,104,5,13.15789474,0.368421053
Greece,1989,4,50,41,9,82,0,50,0,5,4,8,0.08
Greece,1990,2,55,51,4,92.72727273,0,55,0,10,2,3.636363636,0.036363636
Greece,1991,15,57,52,5,91.22807018,0,57,0,23,6,10.52631579,0.263157895
Greece,1992,2,35,34,1,97.14285714,0,35,0,34,2,5.714285714,0.057142857
Greece,1994,3,42,38,4,90.47619048,0,42,0,19,3,7.142857143,0.071428571
Greece,1995,0,8,8,0,100,0,8,0,0,0,0,0
Greece,1996,0,20,19,1,95,0,20,0,3,0,0,0
Greece,1997,1,21,16,5,76.19047619,0,21,0,3,1,4.761904762,0.047619048
Greece,1998,0,28,28,0,100,0,28,0,2,0,0,0
Greece,1999,1,35,28,7,80,0,35,0,4,1,2.857142857,0.028571429
Greece,2000,1,28,26,2,92.85714286,0,28,0,0,1,3.571428571,0.035714286
Greece,2001,0,14,11,3,78.57142857,0,14,0,3,0,0,0
Greece,2002,0,11,9,2,81.81818182,0,11,0,2,0,0,0
Greece,2003,0,12,10,2,83.33333333,0,12,0,2,0,0,0
Greece,2004,0,4,3,1,75,0,4,0,3,0,0,0
Greece,2005,0,6,6,0,100,0,6,0,5,0,0,0
Greece,2006,0,23,23,0,100,0,23,0,2,0,0,0
Greece,2007,0,15,15,0,100,0,15,0,3,0,0,0
Greece,2008,0,53,48,5,90.56603774,0,53,0,3,0,0,0
Greece,2009,1,115,113,2,98.26086957,0,115,0,10,1,0.869565217,0.008695652
Greece,2010,4,49,32,17,65.30612245,0,49,0,5,4,8.163265306,0.081632653
Greece,2011,0,11,8,3,72.72727273,0,11,0,5,0,0,0
Greece,2012,0,22,19,3,86.36363636,0,22,0,3,0,0,0
Greece,2013,3,54,46,8,85.18518519,0,54,0,7,2,3.703703704,0.055555556
Greece,2014,0,26,22,4,84.61538462,0,26,0,4,0,0,0
Greece,2015,1,31,27,4,87.09677419,0,31,0,2,1,3.225806452,0.032258065
Greece,2016,66,31,24,7,77.41935484,0,31,0,2,1,3.225806452,2.129032258
Greece,2017,0,43,33,10,76.74418605,0,43,0,7,0,0,0
Grenada,1980,9,4,3,1,75,0,4,0,20,4,100,2.25
Grenada,1983,0,1,0,1,0,0,1,0,1,0,0,0
Guadeloupe,1980,1,9,6,3,66.66666667,0,9,0,2,1,11.11111111,0.111111111
Guadeloupe,1981,0,1,1,0,100,0,1,0,0,0,0,0
Guadeloupe,1983,0,17,16,1,94.11764706,0,17,0,20,0,0,0
Guadeloupe,1984,4,14,10,4,71.42857143,0,14,0,5,2,14.28571429,0.285714286
Guadeloupe,1985,2,9,8,1,88.88888889,0,9,0,18,1,11.11111111,0.222222222
Guadeloupe,1986,0,1,1,0,100,0,1,0,0,0,0,0
Guadeloupe,1988,0,4,4,0,100,0,4,0,0,0,0,0
Guadeloupe,1991,1,1,1,0,100,0,1,0,0,1,100,1
Guatemala,1970,2,4,4,0,100,0,4,0,0,2,50,0.5
Guatemala,1971,0,1,1,0,100,0,1,0,0,0,0,0
Guatemala,1974,0,1,1,0,100,0,1,0,0,0,0,0
Guatemala,1975,23,5,4,1,80,0,5,0,1,3,60,4.6
Guatemala,1976,8,13,12,1,92.30769231,0,13,0,8,6,46.15384615,0.615384615
Guatemala,1977,6,8,8,0,100,0,8,0,0,4,50,0.75
Guatemala,1978,35,29,27,2,93.10344828,0,29,0,18,16,55.17241379,1.206896552
Guatemala,1979,53,60,56,4,93.33333333,0,60,0,19,22,36.66666667,0.883333333
Guatemala,1980,528,281,267,14,95.01779359,0,281,0,143,199,70.81850534,1.879003559
Guatemala,1981,1381,399,384,15,96.2406015,0,399,0,285,229,57.39348371,3.461152882
Guatemala,1982,1562,354,348,6,98.30508475,0,354,0,152,181,51.1299435,4.412429379
Guatemala,1983,530,117,111,6,94.87179487,0,117,0,176,72,61.53846154,4.52991453
Guatemala,1984,171,74,67,7,90.54054054,0,74,0,34,43,58.10810811,2.310810811
Guatemala,1985,137,63,63,0,100,0,63,0,17,41,65.07936508,2.174603175
Guatemala,1986,54,31,26,5,83.87096774,0,31,0,14,18,58.06451613,1.741935484
Guatemala,1987,211,56,56,0,100,0,56,0,38,19,33.92857143,3.767857143
Guatemala,1988,135,29,28,1,96.55172414,0,29,0,35,18,62.06896552,4.655172414
Guatemala,1989,43,79,75,4,94.93670886,0,79,0,70,22,27.84810127,0.544303797
Guatemala,1990,68,83,78,5,93.97590361,0,83,0,42,35,42.1686747,0.819277108
Guatemala,1991,73,77,72,5,93.50649351,0,77,0,22,24,31.16883117,0.948051948
Guatemala,1992,28,48,42,6,87.5,0,48,0,67,12,25,0.583333333
Guatemala,1994,22,84,70,14,83.33333333,0,84,0,39,11,13.0952381,0.261904762
Guatemala,1995,40,82,74,8,90.24390244,0,82,0,10,32,39.02439024,0.487804878
Guatemala,1996,14,26,23,3,88.46153846,0,26,0,9,8,30.76923077,0.538461538
Guatemala,1997,22,26,24,2,92.30769231,0,26,0,22,13,50,0.846153846
Guatemala,1999,3,1,1,0,100,0,1,0,0,1,100,3
Guatemala,2000,2,1,1,0,100,0,1,0,0,1,100,2
Guatemala,2001,1,2,0,2,0,0,2,0,1,1,50,0.5
Guatemala,2003,1,3,1,2,33.33333333,0,3,0,5,1,33.33333333,0.333333333
Guatemala,2004,3,2,2,0,100,0,2,0,0,2,100,1.5
Guatemala,2006,5,4,4,0,100,0,4,0,0,4,100,1.25
Guatemala,2012,2,1,1,0,100,0,1,0,1,1,100,2
Guatemala,2013,4,6,5,1,83.33333333,0,6,0,3,4,66.66666667,0.666666667
Guinea,1980,1,2,1,1,50,0,2,0,1,1,50,0.5
Guinea,1992,0,2,1,1,50,0,2,0,0,0,0,0
Guinea,1994,2,2,2,0,100,0,2,0,20,1,50,1
Guinea,1996,2,1,1,0,100,0,1,0,0,1,100,2
Guinea,2000,206,12,12,0,100,0,12,0,32,10,83.33333333,17.16666667
Guinea,2005,0,1,0,1,0,0,1,0,0,0,0,0
Guinea,2013,0,2,2,0,100,0,2,0,0,0,0,0
Guinea,2015,1,2,1,1,50,0,2,0,4,1,50,0.5
Guinea,2016,1,1,1,0,100,0,1,0,0,1,100,1
Guinea-Bissau,2001,0,1,0,1,0,0,1,0,0,0,0,0
Guinea-Bissau,2003,1,1,1,0,100,0,1,0,0,1,100,1
Guinea-Bissau,2005,3,4,4,0,100,0,4,0,15,3,75,0.75
Guinea-Bissau,2006,11,1,1,0,100,0,1,0,12,1,100,11
Guinea-Bissau,2009,1,1,1,0,100,0,1,0,0,1,100,1
Guinea-Bissau,2012,1,1,1,0,100,0,1,0,0,1,100,1
Guyana,1978,5,1,1,0,100,0,1,0,0,1,100,5
Guyana,1979,1,2,2,0,100,0,2,0,0,1,50,0.5
Guyana,1980,1,1,0,1,0,0,1,0,1,1,100,1
Guyana,1981,1,1,1,0,100,0,1,0,0,1,100,1
Guyana,1990,0,5,2,3,40,0,5,0,3,0,0,0
Guyana,1992,0,4,3,1,75,0,4,0,1,0,0,0
Guyana,1997,0,1,0,1,0,0,1,0,0,0,0,0
Guyana,1998,0,2,2,0,100,0,2,0,1,0,0,0
Guyana,2001,0,1,1,0,100,0,1,0,0,0,0,0
Guyana,2002,4,1,1,0,100,0,1,0,6,1,100,4
Guyana,2003,0,1,1,0,100,0,1,0,0,0,0,0
Guyana,2006,6,2,2,0,100,0,2,0,0,2,100,3
Guyana,2008,23,3,3,0,100,0,3,0,12,2,66.66666667,7.666666667
Guyana,2016,0,1,0,1,0,0,1,0,0,0,0,0
Haiti,1973,0,1,1,0,100,0,1,0,0,0,0,0
Haiti,1974,0,2,2,0,100,0,2,0,0,0,0,0
Haiti,1983,5,6,4,2,66.66666667,0,6,0,9,2,33.33333333,0.833333333
Haiti,1987,4,10,9,1,90,0,10,0,6,4,40,0.4
Haiti,1988,3,6,6,0,100,0,6,0,0,3,50,0.5
Haiti,1989,0,3,3,0,100,0,3,0,9,0,0,0
Haiti,1990,13,3,3,0,100,0,3,0,106,3,100,4.333333333
Haiti,1991,137,17,15,2,88.23529412,0,17,0,1,5,29.41176471,8.058823529
Haiti,1992,18,27,24,3,88.88888889,0,27,0,7,14,51.85185185,0.666666667
Haiti,1994,87,27,25,2,92.59259259,0,27,0,50,17,62.96296296,3.222222222
Haiti,1995,16,34,29,5,85.29411765,0,34,0,40,14,41.17647059,0.470588235
Haiti,1996,14,27,20,7,74.07407407,0,27,0,7,13,48.14814815,0.518518519
Haiti,1997,9,16,14,2,87.5,0,16,0,11,7,43.75,0.5625
Haiti,1998,0,1,1,0,100,0,1,0,0,0,0,0
Haiti,1999,3,5,3,2,60,0,5,0,3,3,60,0.6
Haiti,2000,5,9,9,0,100,0,9,0,15,4,44.44444444,0.555555556
Haiti,2001,0,5,4,1,80,0,5,0,2,0,0,0
Haiti,2002,0,2,1,1,50,0,2,0,1,0,0,0
Haiti,2003,4,5,5,0,100,0,5,0,1,1,20,0.8
Haiti,2004,7,2,2,0,100,0,2,0,30,2,100,3.5
Haiti,2005,1,1,1,0,100,0,1,0,0,1,100,1
Haiti,2006,2,1,1,0,100,0,1,0,1,1,100,2
Haiti,2007,1,2,2,0,100,0,2,0,1,1,50,0.5
Haiti,2016,7,1,1,0,100,0,1,0,0,1,100,7
Honduras,1973,0,1,1,0,100,0,1,0,0,0,0,0
Honduras,1979,1,6,6,0,100,0,6,0,12,1,16.66666667,0.166666667
Honduras,1980,6,16,14,2,87.5,0,16,0,8,5,31.25,0.375
Honduras,1981,7,17,14,3,82.35294118,0,17,0,14,3,17.64705882,0.411764706
Honduras,1982,24,34,33,1,97.05882353,0,34,0,12,5,14.70588235,0.705882353
Honduras,1983,75,29,27,2,93.10344828,0,29,0,6,13,44.82758621,2.586206897
Honduras,1984,5,12,11,1,91.66666667,0,12,0,1,3,25,0.416666667
Honduras,1985,7,9,9,0,100,0,9,0,8,3,33.33333333,0.777777778
Honduras,1986,10,8,8,0,100,0,8,0,4,2,25,1.25
Honduras,1987,21,20,15,5,75,0,20,0,12,5,25,1.05
Honduras,1988,32,21,18,3,85.71428571,0,21,0,11,6,28.57142857,1.523809524
Honduras,1989,9,29,26,3,89.65517241,0,29,0,22,8,27.5862069,0.310344828
Honduras,1990,3,13,10,3,76.92307692,0,13,0,13,3,23.07692308,0.230769231
Honduras,1991,18,21,18,3,85.71428571,0,21,0,21,9,42.85714286,0.857142857
Honduras,1992,5,12,11,1,91.66666667,0,12,0,5,4,33.33333333,0.416666667
Honduras,1994,10,6,5,1,83.33333333,0,6,0,26,2,33.33333333,1.666666667
Honduras,1995,8,12,11,1,91.66666667,0,12,0,2,8,66.66666667,0.666666667
Honduras,1996,11,19,15,4,78.94736842,0,19,0,29,5,26.31578947,0.578947368
Honduras,1997,14,22,21,1,95.45454545,0,22,0,18,6,27.27272727,0.636363636
Honduras,2002,0,1,1,0,100,0,1,0,0,0,0,0
Honduras,2004,28,1,1,0,100,0,1,0,14,1,100,28
Honduras,2009,2,8,6,2,75,0,8,0,1,1,12.5,0.25
Honduras,2011,2,1,1,0,100,0,1,0,0,1,100,2
Honduras,2013,5,2,2,0,100,0,2,0,0,1,50,2.5
Honduras,2014,0,1,0,1,0,0,1,0,1,0,0,0
Honduras,2016,2,1,1,0,100,0,1,0,0,1,100,2
Honduras,2017,2,1,1,0,100,0,1,0,0,1,100,2
Hong Kong,1980,0,1,1,0,100,0,1,0,2,0,0,0
Hong Kong,1981,0,3,2,1,66.66666667,0,3,0,25,0,0,0
Hong Kong,1989,0,1,0,1,0,0,1,0,0,0,0,0
Hong Kong,1990,0,1,1,0,100,0,1,0,0,0,0,0
Hong Kong,1991,0,1,1,0,100,0,1,0,2,0,0,0
Hong Kong,1992,1,6,4,2,66.66666667,0,6,0,0,1,16.66666667,0.166666667
Hong Kong,1994,3,4,3,1,75,0,4,0,4,2,50,0.75
Hong Kong,1995,0,1,1,0,100,0,1,0,0,0,0,0
Hong Kong,1996,0,3,2,1,66.66666667,0,3,0,5,0,0,0
Hong Kong,2000,0,2,2,0,100,0,2,0,17,0,0,0
Hong Kong,2001,0,1,1,0,100,0,1,0,0,0,0,0
Hong Kong,2005,0,1,1,0,100,0,1,0,1,0,0,0
Hong Kong,2008,0,1,1,0,100,0,1,0,46,0,0,0
Hungary,1989,0,1,1,0,100,0,1,0,0,0,0,0
Hungary,1991,0,3,2,1,66.66666667,0,3,0,3,0,0,0
Hungary,1992,0,1,1,0,100,0,1,0,1,0,0,0
Hungary,1994,0,2,2,0,100,0,2,0,0,0,0,0
Hungary,1996,0,13,12,1,92.30769231,0,13,0,8,0,0,0
Hungary,1997,3,17,14,3,82.35294118,0,17,0,2,2,11.76470588,0.176470588
Hungary,1998,0,2,2,0,100,0,2,0,0,0,0,0
Hungary,2001,1,1,1,0,100,0,1,0,1,1,100,1
Hungary,2008,0,2,2,0,100,0,2,0,0,0,0,0
Hungary,2009,2,1,1,0,100,0,1,0,0,1,100,2
Hungary,2014,0,1,1,0,100,0,1,0,0,0,0,0
Hungary,2015,0,1,0,1,0,0,1,0,0,0,0,0
Hungary,2016,0,1,1,0,100,0,1,0,2,0,0,0
Iceland,1983,0,1,1,0,100,0,1,0,0,0,0,0
Iceland,1986,0,1,1,0,100,0,1,0,0,0,0,0
Iceland,2012,0,1,1,0,100,0,1,0,0,0,0,0
Iceland,2014,0,1,1,0,100,0,1,0,0,0,0,0
India,1972,0,1,1,0,100,0,1,0,0,0,0,0
India,1975,4,1,1,0,100,0,1,0,0,1,100,4
India,1976,0,1,1,0,100,0,1,0,0,0,0,0
India,1977,0,1,1,0,100,0,1,0,0,0,0,0
India,1979,31,20,19,1,95,0,20,0,19,16,80,1.55
India,1980,17,10,9,1,90,0,10,0,13,7,70,1.7
India,1981,24,16,16,0,100,0,16,0,12,7,43.75,1.5
India,1982,64,13,11,2,84.61538462,0,13,0,102,10,76.92307692,4.923076923
India,1983,59,47,39,8,82.9787234,0,47,0,217,19,40.42553191,1.255319149
India,1984,195,159,146,13,91.82389937,0,159,0,364,82,51.57232704,1.226415094
India,1985,51,39,33,6,84.61538462,0,39,0,79,26,66.66666667,1.307692308
India,1986,340,96,91,5,94.79166667,0,96,0,163,83,86.45833333,3.541666667
India,1987,506,166,155,11,93.37349398,0,166,0,429,129,77.71084337,3.048192771
India,1988,966,358,336,22,93.8547486,0,358,0,1033,278,77.65363128,2.698324022
India,1989,874,324,311,13,95.98765432,0,324,0,769,235,72.5308642,2.697530864
India,1990,907,349,334,15,95.70200573,0,349,0,1042,243,69.62750716,2.598853868
India,1991,1113,339,315,24,92.92035398,1,338,0.294985251,1326,216,63.71681416,3.283185841
India,1992,1152,237,227,10,95.78059072,0,237,0,917,167,70.46413502,4.860759494
India,1994,389,107,100,7,93.45794393,0,107,0,405,52,48.59813084,3.635514019
India,1995,361,179,170,9,94.97206704,0,179,0,616,78,43.57541899,2.016759777
India,1996,569,213,183,30,85.91549296,0,213,0,952,132,61.97183099,2.671361502
India,1997,853,193,176,17,91.19170984,0,193,0,1416,133,68.9119171,4.419689119
India,1998,398,61,61,0,100,2,59,3.278688525,411,55,90.16393443,6.524590164
India,1999,469,112,103,9,91.96428571,1,111,0.892857143,591,72,64.28571429,4.1875
India,2000,671,180,173,7,96.11111111,1,179,0.555555556,761,109,60.55555556,3.727777778
India,2001,660,234,216,18,92.30769231,6,228,2.564102564,1144,157,67.09401709,2.820512821
India,2002,599,184,170,14,92.39130435,4,180,2.173913043,1186,126,68.47826087,3.255434783
India,2003,472,196,185,11,94.3877551,3,193,1.530612245,1183,129,65.81632653,2.408163265
India,2004,334,108,98,10,90.74074074,2,106,1.851851852,949,72,66.66666667,3.092592593
India,2005,466,146,138,8,94.52054795,3,143,2.054794521,1216,94,64.38356164,3.191780822
India,2006,722,167,164,3,98.20359281,2,165,1.19760479,2138,97,58.08383234,4.323353293
India,2007,626,149,147,2,98.65771812,3,146,2.013422819,1187,99,66.44295302,4.201342282
India,2008,824,534,456,78,85.39325843,6,528,1.123595506,1759,240,44.94382022,1.543071161
India,2009,774,672,627,45,93.30357143,1,671,0.148809524,854,281,41.81547619,1.151785714
India,2010,812,663,617,46,93.06184012,0,663,0,660,303,45.70135747,1.224736048
India,2011,499,645,570,75,88.37209302,0,645,0,730,244,37.82945736,0.773643411
India,2012,264,611,461,150,75.45008183,1,610,0.163666121,651,162,26.51391162,0.43207856
India,2013,467,694,544,150,78.38616715,3,691,0.432276657,771,224,32.27665706,0.672910663
India,2014,490,860,673,187,78.25581395,1,859,0.11627907,776,237,27.55813953,0.569767442
India,2015,387,884,663,221,75,6,878,0.678733032,649,206,23.30316742,0.437782805
India,2016,467,1025,753,272,73.46341463,8,1017,0.780487805,788,260,25.36585366,0.455609756
India,2017,465,966,786,180,81.36645963,6,960,0.621118012,702,258,26.70807453,0.48136646
Indonesia,1977,1,1,1,0,100,0,1,0,1,1,100,1
Indonesia,1978,0,2,2,0,100,0,2,0,1,0,0,0
Indonesia,1981,4,1,1,0,100,0,1,0,0,1,100,4
Indonesia,1984,2,2,2,0,100,0,2,0,0,1,50,1
Indonesia,1985,7,2,2,0,100,0,2,0,14,1,50,3.5
Indonesia,1986,0,4,4,0,100,0,4,0,2,0,0,0
Indonesia,1989,85,2,2,0,100,0,2,0,27,2,100,42.5
Indonesia,1990,12,3,3,0,100,0,3,0,0,3,100,4
Indonesia,1991,21,7,6,1,85.71428571,0,7,0,60,4,57.14285714,3
Indonesia,1992,33,4,4,0,100,0,4,0,0,3,75,8.25
Indonesia,1994,1,5,5,0,100,0,5,0,6,1,20,0.2
Indonesia,1995,41,24,23,1,95.83333333,0,24,0,51,8,33.33333333,1.708333333
Indonesia,1996,30,65,64,1,98.46153846,0,65,0,188,13,20,0.461538462
Indonesia,1997,102,27,27,0,100,0,27,0,99,17,62.96296296,3.777777778
Indonesia,1998,9,3,3,0,100,0,3,0,5,3,100,3
Indonesia,1999,67,60,54,6,90,0,60,0,79,32,53.33333333,1.116666667
Indonesia,2000,146,101,86,15,85.14851485,0,101,0,336,35,34.65346535,1.445544554
Indonesia,2001,134,105,94,11,89.52380952,1,104,0.952380952,176,42,40,1.276190476
Indonesia,2002,246,43,40,3,93.02325581,2,41,4.651162791,535,19,44.18604651,5.720930233
Indonesia,2003,26,18,15,3,83.33333333,1,17,5.555555556,166,7,38.88888889,1.444444444
Indonesia,2004,42,17,14,3,82.35294118,1,16,5.882352941,238,11,64.70588235,2.470588235
Indonesia,2005,66,15,14,1,93.33333333,2,13,13.33333333,171,8,53.33333333,4.4
Indonesia,2006,6,10,8,2,80,0,10,0,6,3,30,0.6
Indonesia,2007,0,2,2,0,100,0,2,0,1,0,0,0
Indonesia,2008,0,13,9,4,69.23076923,0,13,0,0,0,0,0
Indonesia,2009,15,19,16,3,84.21052632,2,17,10.52631579,62,7,36.84210526,0.789473684
Indonesia,2010,0,4,4,0,100,0,4,0,6,0,0,0
Indonesia,2011,20,21,15,6,71.42857143,2,19,9.523809524,70,9,42.85714286,0.952380952
Indonesia,2012,15,39,29,10,74.35897436,0,39,0,20,7,17.94871795,0.384615385
Indonesia,2013,23,32,25,7,78.125,1,31,3.125,16,10,31.25,0.71875
Indonesia,2014,20,35,32,3,91.42857143,0,35,0,30,13,37.14285714,0.571428571
Indonesia,2015,22,29,25,4,86.20689655,0,29,0,17,13,44.82758621,0.75862069
Indonesia,2016,22,19,13,6,68.42105263,4,15,21.05263158,35,8,42.10526316,1.157894737
Indonesia,2017,20,27,22,5,81.48148148,2,25,7.407407407,27,10,37.03703704,0.740740741
International,2002,1,1,1,0,100,1,0,100,12,1,100,1
Iran,1970,0,5,4,1,80,0,5,0,1,0,0,0
Iran,1971,4,11,10,1,90.90909091,0,11,0,0,2,18.18181818,0.363636364
Iran,1972,1,15,12,3,80,0,15,0,3,1,6.666666667,0.066666667
Iran,1973,1,4,4,0,100,0,4,0,0,1,25,0.25
Iran,1974,1,11,11,0,100,0,11,0,0,1,9.090909091,0.090909091
Iran,1975,8,13,12,1,92.30769231,0,13,0,0,7,53.84615385,0.615384615
Iran,1976,5,4,3,1,75,0,4,0,0,3,75,1.25
Iran,1977,2,5,4,1,80,0,5,0,1,1,20,0.4
Iran,1978,447,27,25,2,92.59259259,0,27,0,60,13,48.14814815,16.55555556
Iran,1979,57,82,68,14,82.92682927,0,82,0,251,20,24.3902439,0.695121951
Iran,1980,55,67,58,9,86.56716418,0,67,0,381,17,25.37313433,0.820895522
Iran,1981,224,108,87,21,80.55555556,0,108,0,263,51,47.22222222,2.074074074
Iran,1982,139,26,20,6,76.92307692,0,26,0,985,18,69.23076923,5.346153846
Iran,1983,0,10,7,3,70,0,10,0,6,0,0,0
Iran,1984,29,17,12,5,70.58823529,0,17,0,355,6,35.29411765,1.705882353
Iran,1985,22,3,3,0,100,0,3,0,52,3,100,7.333333333
Iran,1986,39,6,5,1,83.33333333,0,6,0,144,4,66.66666667,6.5
Iran,1987,0,1,1,0,100,0,1,0,0,0,0,0
Iran,1988,18,6,4,2,66.66666667,0,6,0,7,4,66.66666667,3
Iran,1989,14,6,5,1,83.33333333,0,6,0,0,3,50,2.333333333
Iran,1990,10,11,9,2,81.81818182,0,11,0,2,4,36.36363636,0.909090909
Iran,1991,2,9,9,0,100,0,9,0,0,1,11.11111111,0.222222222
Iran,1992,9,16,16,0,100,0,16,0,5,3,18.75,0.5625
Iran,1994,74,43,42,1,97.6744186,0,43,0,327,4,9.302325581,1.720930233
Iran,1995,0,8,8,0,100,0,8,0,11,0,0,0
Iran,1996,3,3,3,0,100,0,3,0,2,2,66.66666667,1
Iran,1998,6,5,3,2,60,0,5,0,6,2,40,1.2
Iran,1999,4,8,6,2,75,0,8,0,16,3,37.5,0.5
Iran,2000,5,15,13,2,86.66666667,0,15,0,29,3,20,0.333333333
Iran,2001,0,4,3,1,75,0,4,0,0,0,0,0
Iran,2003,0,2,1,1,50,0,2,0,0,0,0,0
Iran,2005,13,5,4,1,80,0,5,0,191,3,60,2.6
Iran,2006,48,14,14,0,100,0,14,0,41,5,35.71428571,3.428571429
Iran,2007,24,9,9,0,100,1,8,11.11111111,5,5,55.55555556,2.666666667
Iran,2008,26,8,8,0,100,1,7,12.5,220,5,62.5,3.25
Iran,2009,97,15,14,1,93.33333333,2,13,13.33333333,83,10,66.66666667,6.466666667
Iran,2010,115,14,14,0,100,2,12,14.28571429,450,12,85.71428571,8.214285714
Iran,2011,18,13,13,0,100,0,13,0,13,10,76.92307692,1.384615385
Iran,2012,12,5,5,0,100,1,4,20,11,5,100,2.4
Iran,2013,39,11,10,1,90.90909091,1,10,9.090909091,17,10,90.90909091,3.545454545
Iran,2014,13,9,9,0,100,0,9,0,5,7,77.77777778,1.444444444
Iran,2015,38,9,8,1,88.88888889,0,9,0,11,7,77.77777778,4.222222222
Iran,2016,12,10,8,2,80,0,10,0,8,5,50,1.2
Iran,2017,39,11,10,1,90.90909091,2,9,18.18181818,67,10,90.90909091,3.545454545
Iraq,1975,0,1,1,0,100,0,1,0,1,0,0,0
Iraq,1976,12,3,3,0,100,0,3,0,285,2,66.66666667,4
Iraq,1979,1,2,2,0,100,0,2,0,0,1,50,0.5
Iraq,1980,8,6,4,2,66.66666667,0,6,0,9,3,50,1.333333333
Iraq,1981,0,3,3,0,100,0,3,0,0,0,0,0
Iraq,1982,96,5,5,0,100,0,5,0,138,2,40,19.2
Iraq,1983,1,3,2,1,66.66666667,0,3,0,0,1,33.33333333,0.333333333
Iraq,1984,0,2,2,0,100,0,2,0,1,0,0,0
Iraq,1987,0,3,3,0,100,0,3,0,4,0,0,0
Iraq,1988,43,4,4,0,100,0,4,0,104,3,75,10.75
Iraq,1989,0,4,4,0,100,0,4,0,25,0,0,0
Iraq,1991,1,3,2,1,66.66666667,0,3,0,2,1,33.33333333,0.333333333
Iraq,1992,117,35,30,5,85.71428571,0,35,0,88,16,45.71428571,3.342857143
Iraq,1994,75,18,17,1,94.44444444,0,18,0,195,10,55.55555556,4.166666667
Iraq,1995,156,17,12,5,70.58823529,0,17,0,256,10,58.82352941,9.176470588
Iraq,1996,11,12,9,3,75,0,12,0,14,5,41.66666667,0.916666667
Iraq,1997,106,21,18,3,85.71428571,0,21,0,23,11,52.38095238,5.047619048
Iraq,1998,19,7,7,0,100,0,7,0,16,3,42.85714286,2.714285714
Iraq,1999,32,12,12,0,100,1,11,8.333333333,105,7,58.33333333,2.666666667
Iraq,2000,10,10,9,1,90,0,10,0,29,4,40,1
Iraq,2001,9,3,3,0,100,0,3,0,30,2,66.66666667,3
Iraq,2002,10,6,4,2,66.66666667,0,6,0,4,3,50,1.666666667
Iraq,2003,391,102,91,11,89.21568627,20,82,19.60784314,1441,71,69.60784314,3.833333333
Iraq,2004,2171,323,313,10,96.90402477,73,250,22.6006192,4212,245,75.85139319,6.721362229
Iraq,2005,3384,617,598,19,96.92058347,166,451,26.90437601,6067,504,81.68557536,5.484602917
Iraq,2006,4616,838,825,13,98.44868735,98,740,11.69451074,8263,648,77.32696897,5.508353222
Iraq,2007,6667,1047,1038,9,99.14040115,208,839,19.86628462,13283,795,75.93123209,6.367717287
Iraq,2008,2864,1106,1054,52,95.29837251,106,1000,9.584086799,6709,640,57.86618445,2.589511754
Iraq,2009,2585,1137,1056,81,92.87598945,56,1081,4.925241865,9389,535,47.05364996,2.273526825
Iraq,2010,2074,1179,1073,106,91.00932994,50,1129,4.240882103,6917,580,49.1942324,1.759117897
Iraq,2011,1870,1308,1183,125,90.44342508,46,1262,3.516819572,5041,712,54.43425076,1.429663609
Iraq,2012,2686,1437,1389,48,96.65970772,69,1368,4.801670146,6995,917,63.81350035,1.869171886
Iraq,2013,7041,2852,2672,180,93.68863955,273,2579,9.572230014,15710,2110,73.98316971,2.468793829
Iraq,2014,13965,3933,3656,277,92.95703026,307,3626,7.80574625,16804,2525,64.20035596,3.550724638
Iraq,2015,8885,2751,2369,382,86.11414031,345,2406,12.54089422,13326,2173,78.98945838,3.229734642
Iraq,2016,12207,3360,2633,727,78.36309524,454,2906,13.51190476,14288,2251,66.99404762,3.633035714
Iraq,2017,6476,2466,1755,711,71.16788321,330,2136,13.38199513,4916,1260,51.09489051,2.626115166
Ireland,1970,1,1,1,0,100,0,1,0,0,1,100,1
Ireland,1971,1,1,1,0,100,0,1,0,0,1,100,1
Ireland,1972,6,5,5,0,100,0,5,0,0,3,60,1.2
Ireland,1973,4,3,3,0,100,0,3,0,0,3,100,1.333333333
Ireland,1974,34,3,3,0,100,0,3,0,0,3,100,11.33333333
Ireland,1975,7,7,7,0,100,0,7,0,0,6,85.71428571,1
Ireland,1976,5,5,5,0,100,0,5,0,0,4,80,1
Ireland,1977,2,3,3,0,100,0,3,0,0,2,66.66666667,0.666666667
Ireland,1978,1,3,3,0,100,0,3,0,0,1,33.33333333,0.333333333
Ireland,1979,9,8,8,0,100,0,8,0,0,6,75,1.125
Ireland,1980,12,7,7,0,100,0,7,0,8,4,57.14285714,1.714285714
Ireland,1981,2,5,4,1,80,0,5,0,0,2,40,0.4
Ireland,1982,2,4,3,1,75,0,4,0,1,2,50,0.5
Ireland,1983,5,4,3,1,75,0,4,0,0,3,75,1.25
Ireland,1984,1,1,0,1,0,0,1,0,0,1,100,1
Ireland,1985,2,2,2,0,100,0,2,0,0,2,100,1
Ireland,1986,0,2,1,1,50,0,2,0,0,0,0,0
Ireland,1987,6,24,6,18,25,0,24,0,0,5,20.83333333,0.25
Ireland,1989,3,3,3,0,100,0,3,0,0,3,100,1
Ireland,1990,0,2,2,0,100,0,2,0,0,0,0,0
Ireland,1991,3,16,8,8,50,0,16,0,0,3,18.75,0.1875
Ireland,1992,0,7,6,1,85.71428571,0,7,0,0,0,0,0
Ireland,1994,4,10,8,2,80,0,10,0,2,4,40,0.4
Ireland,1995,1,3,1,2,33.33333333,0,3,0,1,1,33.33333333,0.333333333
Ireland,1996,1,1,1,0,100,0,1,0,0,1,100,1
Ireland,1997,0,4,0,4,0,0,4,0,0,0,0,0
Ireland,1998,1,3,1,2,33.33333333,0,3,0,2,1,33.33333333,0.333333333
Ireland,1999,0,3,1,2,33.33333333,0,3,0,1,0,0,0
Ireland,2001,0,2,2,0,100,0,2,0,2,0,0,0
Ireland,2003,0,1,0,1,0,0,1,0,0,0,0,0
Ireland,2006,1,1,1,0,100,0,1,0,0,1,100,1
Ireland,2007,0,1,1,0,100,0,1,0,0,0,0,0
Ireland,2008,0,5,2,3,40,0,5,0,0,0,0,0
Ireland,2010,0,4,3,1,75,0,4,0,8,0,0,0
Ireland,2011,1,4,2,2,50,0,4,0,0,1,25,0.25
Ireland,2012,0,29,3,26,10.34482759,0,29,0,0,0,0,0
Ireland,2013,0,27,5,22,18.51851852,0,27,0,2,0,0,0
Ireland,2014,0,33,9,24,27.27272727,0,33,0,1,0,0,0
Ireland,2015,0,28,6,22,21.42857143,0,28,0,0,0,0,0
Ireland,2016,2,15,5,10,33.33333333,0,15,0,3,2,13.33333333,0.133333333
Ireland,2017,0,17,4,13,23.52941176,0,17,0,0,0,0,0
Israel,1971,1,1,1,0,100,0,1,0,11,1,100,1
Israel,1972,26,15,1,14,6.666666667,0,15,0,72,1,6.666666667,1.733333333
Israel,1973,2,1,1,0,100,0,1,0,18,1,100,2
Israel,1974,78,12,12,0,100,0,12,0,145,8,66.66666667,6.5
Israel,1975,24,2,2,0,100,0,2,0,62,2,100,12
Israel,1976,1,2,2,0,100,0,2,0,39,1,50,0.5
Israel,1977,5,6,6,0,100,0,6,0,24,4,66.66666667,0.833333333
Israel,1978,52,23,21,2,91.30434783,0,23,0,259,5,21.73913043,2.260869565
Israel,1979,64,130,102,28,78.46153846,0,130,0,385,25,19.23076923,0.492307692
Israel,1980,14,79,56,23,70.88607595,0,79,0,79,6,7.594936709,0.17721519
Israel,1981,3,36,27,9,75,0,36,0,28,3,8.333333333,0.083333333
Israel,1982,3,71,53,18,74.64788732,0,71,0,16,3,4.225352113,0.042253521
Israel,1983,16,31,24,7,77.41935484,0,31,0,72,4,12.90322581,0.516129032
Israel,1984,7,25,20,5,80,0,25,0,90,3,12,0.28
Israel,1985,12,21,19,2,90.47619048,1,20,4.761904762,46,1,4.761904762,0.571428571
Israel,1986,8,48,43,5,89.58333333,0,48,0,144,7,14.58333333,0.166666667
Israel,1987,11,23,16,7,69.56521739,0,23,0,62,5,21.73913043,0.47826087
Israel,1988,13,35,23,12,65.71428571,0,35,0,43,6,17.14285714,0.371428571
Israel,1989,43,87,66,21,75.86206897,1,86,1.149425287,75,24,27.5862069,0.494252874
Israel,1990,57,98,65,33,66.32653061,0,98,0,192,31,31.63265306,0.581632653
Israel,1991,31,64,43,21,67.1875,0,64,0,51,25,39.0625,0.484375
Israel,1992,38,78,53,25,67.94871795,0,78,0,110,27,34.61538462,0.487179487
Israel,1994,60,55,39,16,70.90909091,4,51,7.272727273,198,23,41.81818182,1.090909091
Israel,1995,18,13,10,3,76.92307692,2,11,15.38461538,147,7,53.84615385,1.384615385
Israel,1996,73,19,16,3,84.21052632,5,14,26.31578947,226,10,52.63157895,3.842105263
Israel,1997,31,13,12,1,92.30769231,2,11,15.38461538,448,7,53.84615385,2.384615385
Israel,1998,19,14,13,1,92.85714286,1,13,7.142857143,120,7,50,1.357142857
Israel,1999,6,8,8,0,100,2,6,25,53,4,50,0.75
Israel,2000,11,15,13,2,86.66666667,0,15,0,119,5,33.33333333,0.733333333
Israel,2001,141,79,71,8,89.87341772,25,54,31.64556962,905,39,49.36708861,1.784810127
Israel,2002,337,75,67,8,89.33333333,45,30,60,1519,58,77.33333333,4.493333333
Israel,2003,156,38,35,3,92.10526316,18,20,47.36842105,570,22,57.89473684,4.105263158
Israel,2004,59,19,18,1,94.73684211,7,12,36.84210526,248,12,63.15789474,3.105263158
Israel,2005,45,43,41,2,95.34883721,5,38,11.62790698,251,14,32.55813953,1.046511628
Israel,2006,57,81,75,6,92.59259259,4,77,4.938271605,160,13,16.04938272,0.703703704
Israel,2007,17,53,50,3,94.33962264,1,52,1.886792453,27,6,11.32075472,0.320754717
Israel,2008,34,134,121,13,90.29850746,3,131,2.23880597,240,16,11.94029851,0.253731343
Israel,2009,1,36,35,1,97.22222222,0,36,0,40,1,2.777777778,0.027777778
Israel,2010,4,14,14,0,100,1,13,7.142857143,17,3,21.42857143,0.285714286
Israel,2011,21,51,49,2,96.07843137,1,50,1.960784314,77,7,13.7254902,0.411764706
Israel,2012,14,65,52,13,80,1,64,1.538461538,90,6,9.230769231,0.215384615
Israel,2013,2,37,27,10,72.97297297,0,37,0,8,2,5.405405405,0.054054054
Israel,2014,49,293,151,142,51.53583618,0,293,0,152,18,6.14334471,0.167235495
Israel,2015,20,58,44,14,75.86206897,0,58,0,118,13,22.4137931,0.344827586
Israel,2016,16,50,43,7,86,1,49,2,175,8,16,0.32
Israel,2017,3,32,23,9,71.875,0,32,0,15,3,9.375,0.09375
Italy,1970,0,3,1,2,33.33333333,0,3,0,0,0,0,0
Italy,1971,0,3,3,0,100,0,3,0,0,0,0,0
Italy,1972,1,4,4,0,100,0,4,0,4,1,25,0.25
Italy,1973,62,15,14,1,93.33333333,0,15,0,51,3,20,4.133333333
Italy,1974,23,22,22,0,100,0,22,0,150,4,18.18181818,1.045454545
Italy,1975,0,7,7,0,100,0,7,0,0,0,0,0
Italy,1976,9,173,165,8,95.37572254,0,173,0,38,9,5.202312139,0.052023121
Italy,1977,25,308,278,30,90.25974026,0,308,0,57,23,7.467532468,0.081168831
Italy,1978,26,277,257,20,92.77978339,0,277,0,46,16,5.776173285,0.093862816
Italy,1979,24,209,188,21,89.95215311,0,209,0,138,23,11.00478469,0.114832536
Italy,1980,134,110,104,6,94.54545455,0,110,0,265,36,32.72727273,1.218181818
Italy,1981,24,69,64,5,92.75362319,0,69,0,38,19,27.53623188,0.347826087
Italy,1982,12,23,21,2,91.30434783,0,23,0,59,9,39.13043478,0.52173913
Italy,1983,2,7,5,2,71.42857143,0,7,0,3,2,28.57142857,0.285714286
Italy,1984,23,14,12,2,85.71428571,0,14,0,116,8,57.14285714,1.642857143
Italy,1985,19,11,10,1,90.90909091,0,11,0,157,3,27.27272727,1.727272727
Italy,1986,1,7,5,2,71.42857143,0,7,0,1,1,14.28571429,0.142857143
Italy,1987,3,14,13,1,92.85714286,0,14,0,0,3,21.42857143,0.214285714
Italy,1988,6,29,25,4,86.20689655,0,29,0,19,2,6.896551724,0.206896552
Italy,1989,0,15,13,2,86.66666667,0,15,0,1,0,0,0
Italy,1990,0,6,6,0,100,0,6,0,0,0,0,0
Italy,1991,0,31,23,8,74.19354839,0,31,0,6,0,0,0
Italy,1992,17,37,29,8,78.37837838,0,37,0,23,7,18.91891892,0.459459459
Italy,1994,2,18,14,4,77.77777778,0,18,0,8,2,11.11111111,0.111111111
Italy,1995,0,1,1,0,100,0,1,0,1,0,0,0
Italy,1996,0,8,7,1,87.5,0,8,0,1,0,0,0
Italy,1997,0,8,6,2,75,0,8,0,0,0,0,0
Italy,1998,0,6,6,0,100,0,6,0,14,0,0,0
Italy,1999,1,7,5,2,71.42857143,0,7,0,0,1,14.28571429,0.142857143
Italy,2000,0,8,4,4,50,0,8,0,3,0,0,0
Italy,2001,0,11,7,4,63.63636364,0,11,0,4,0,0,0
Italy,2002,1,7,3,4,42.85714286,0,7,0,0,1,14.28571429,0.142857143
Italy,2003,0,15,11,4,73.33333333,0,15,0,51,0,0,0
Italy,2004,1,3,3,0,100,1,2,33.33333333,0,1,33.33333333,0.333333333
Italy,2005,1,6,6,0,100,0,6,0,7,1,16.66666667,0.166666667
Italy,2006,0,4,2,2,50,0,4,0,2,0,0,0
Italy,2008,0,2,2,0,100,0,2,0,0,0,0,0
Italy,2009,0,4,3,1,75,0,4,0,2,0,0,0
Italy,2010,0,10,6,4,60,0,10,0,3,0,0,0
Italy,2011,2,5,4,1,80,0,5,0,5,1,20,0.4
Italy,2012,0,10,7,3,70,0,10,0,1,0,0,0
Italy,2013,0,7,3,4,42.85714286,0,7,0,4,0,0,0
Italy,2014,0,7,6,1,85.71428571,0,7,0,3,0,0,0
Italy,2015,0,5,4,1,80,0,5,0,1,0,0,0
Italy,2016,1,11,6,5,54.54545455,0,11,0,1,1,9.090909091,0.090909091
Italy,2017,0,8,7,1,87.5,0,8,0,8,0,0,0
Jamaica,1974,0,2,2,0,100,0,2,0,0,0,0,0
Jamaica,1976,0,1,1,0,100,0,1,0,0,0,0,0
Jamaica,1979,4,2,2,0,100,0,2,0,0,2,100,2
Jamaica,1980,11,6,4,2,66.66666667,0,6,0,1,4,66.66666667,1.833333333
Jamaica,1981,5,1,1,0,100,0,1,0,0,1,100,5
Jamaica,1986,3,1,1,0,100,0,1,0,0,1,100,3
Jamaica,1991,0,1,1,0,100,0,1,0,0,0,0,0
Jamaica,1992,5,6,6,0,100,0,6,0,0,4,66.66666667,0.833333333
Jamaica,1994,2,2,2,0,100,0,2,0,0,2,100,1
Jamaica,1995,1,1,1,0,100,0,1,0,1,1,100,1
Jamaica,1996,1,1,1,0,100,0,1,0,0,1,100,1
Jamaica,1997,10,8,7,1,87.5,0,8,0,32,3,37.5,1.25
Jamaica,2007,0,1,1,0,100,0,1,0,1,0,0,0
Jamaica,2014,0,1,0,1,0,0,1,0,1,0,0,0
Jamaica,2017,0,2,2,0,100,0,2,0,0,0,0,0
Japan,1970,0,2,2,0,100,0,2,0,0,0,0,0
Japan,1973,0,2,2,0,100,0,2,0,0,0,0,0
Japan,1974,0,3,3,0,100,0,3,0,7,0,0,0
Japan,1975,0,12,12,0,100,0,12,0,2,0,0,0
Japan,1976,2,1,1,0,100,0,1,0,0,1,100,2
Japan,1977,0,4,4,0,100,0,4,0,0,0,0,0
Japan,1978,4,35,29,6,82.85714286,0,35,0,53,4,11.42857143,0.114285714
Japan,1979,5,16,14,2,87.5,0,16,0,2,2,12.5,0.3125
Japan,1981,0,1,1,0,100,0,1,0,0,0,0,0
Japan,1982,0,2,2,0,100,0,2,0,0,0,0,0
Japan,1983,2,12,10,2,83.33333333,0,12,0,1,1,8.333333333,0.166666667
Japan,1984,0,15,13,2,86.66666667,0,15,0,11,0,0,0
Japan,1985,2,10,10,0,100,0,10,0,7,1,10,0.2
Japan,1986,3,10,10,0,100,0,10,0,1,1,10,0.3
Japan,1987,1,10,9,1,90,0,10,0,3,1,10,0.1
Japan,1988,0,16,12,4,75,0,16,0,26,0,0,0
Japan,1989,2,13,10,3,76.92307692,0,13,0,1,2,15.38461538,0.153846154
Japan,1990,2,93,84,9,90.32258065,0,93,0,125,2,2.150537634,0.021505376
Japan,1991,1,19,16,3,84.21052632,0,19,0,1,1,5.263157895,0.052631579
Japan,1992,0,40,30,10,75,0,40,0,0,0,0,0
Japan,1994,8,9,8,1,88.88888889,0,9,0,504,2,22.22222222,0.888888889
Japan,1995,15,20,14,6,70,0,20,0,6225,3,15,0.75
Japan,1996,0,8,8,0,100,0,8,0,2,0,0,0
Japan,1997,0,5,5,0,100,0,5,0,0,0,0,0
Japan,1998,0,1,1,0,100,0,1,0,1,0,0,0
Japan,1999,0,2,2,0,100,0,2,0,0,0,0,0
Japan,2000,0,13,1,12,7.692307692,0,13,0,0,0,0,0
Japan,2001,0,3,3,0,100,0,3,0,0,0,0,0
Japan,2002,0,2,2,0,100,0,2,0,0,0,0,0
Japan,2003,0,2,2,0,100,0,2,0,0,0,0,0
Japan,2008,0,3,3,0,100,0,3,0,0,0,0,0
Japan,2009,0,1,1,0,100,0,1,0,0,0,0,0
Japan,2013,0,1,1,0,100,0,1,0,0,0,0,0
Japan,2014,0,5,5,0,100,0,5,0,0,0,0,0
Japan,2015,0,10,10,0,100,0,10,0,0,0,0,0
Japan,2016,19,1,1,0,100,0,1,0,26,1,100,19
Jordan,1970,1,9,8,1,88.88888889,0,9,0,1,1,11.11111111,0.111111111
Jordan,1971,0,5,4,1,80,0,5,0,0,0,0,0
Jordan,1972,2,7,1,6,14.28571429,0,7,0,0,2,28.57142857,0.285714286
Jordan,1973,0,1,0,1,0,0,1,0,0,0,0,0
Jordan,1976,9,1,1,0,100,0,1,0,5,1,100,9
Jordan,1980,1,1,1,0,100,0,1,0,0,1,100,1
Jordan,1981,0,2,0,2,0,0,2,0,2,0,0,0
Jordan,1982,0,1,1,0,100,0,1,0,6,0,0,0
Jordan,1983,0,7,4,3,57.14285714,0,7,0,1,0,0,0
Jordan,1984,1,5,4,1,80,0,5,0,4,1,20,0.2
Jordan,1988,0,1,1,0,100,0,1,0,0,0,0,0
Jordan,1990,0,3,3,0,100,0,3,0,5,0,0,0
Jordan,1991,1,11,8,3,72.72727273,0,11,0,8,1,9.090909091,0.090909091
Jordan,1992,1,2,2,0,100,0,2,0,0,1,50,0.5
Jordan,1994,0,6,5,1,83.33333333,0,6,0,7,0,0,0
Jordan,1995,1,3,3,0,100,0,3,0,2,1,33.33333333,0.333333333
Jordan,1996,0,2,0,2,0,0,2,0,1,0,0,0
Jordan,1997,0,3,2,1,66.66666667,0,3,0,4,0,0,0
Jordan,1998,0,1,0,1,0,0,1,0,0,0,0,0
Jordan,1999,0,2,1,1,50,0,2,0,1,0,0,0
Jordan,2000,0,2,1,1,50,0,2,0,2,0,0,0
Jordan,2001,1,2,2,0,100,0,2,0,0,1,50,0.5
Jordan,2002,3,2,2,0,100,0,2,0,0,2,100,1.5
Jordan,2005,62,4,4,0,100,3,1,75,101,4,100,15.5
Jordan,2006,1,1,1,0,100,0,1,0,6,1,100,1
Jordan,2010,1,2,2,0,100,0,2,0,4,1,50,0.5
Jordan,2012,1,2,1,1,50,0,2,0,16,1,50,0.5
Jordan,2013,0,1,0,1,0,0,1,0,0,0,0,0
Jordan,2014,1,3,2,1,66.66666667,0,3,0,7,1,33.33333333,0.333333333
Jordan,2015,7,4,4,0,100,0,4,0,11,2,50,1.75
Jordan,2016,35,9,8,1,88.88888889,2,7,22.22222222,65,6,66.66666667,3.888888889
Jordan,2017,4,8,8,0,100,0,8,0,1,2,25,0.5
Kazakhstan,1992,9,5,4,1,80,0,5,0,1,4,80,1.8
Kazakhstan,1994,0,1,1,0,100,0,1,0,0,0,0,0
Kazakhstan,1997,2,2,2,0,100,0,2,0,0,2,100,1
Kazakhstan,2000,2,1,1,0,100,0,1,0,0,1,100,2
Kazakhstan,2001,0,1,1,0,100,0,1,0,1,0,0,0
Kazakhstan,2008,2,1,1,0,100,0,1,0,2,1,100,2
Kazakhstan,2011,12,5,5,0,100,2,3,40,2,4,80,2.4
Kazakhstan,2012,2,4,3,1,75,0,4,0,3,1,25,0.5
Kazakhstan,2013,0,4,1,3,25,0,4,0,1,0,0,0
Kazakhstan,2016,10,3,3,0,100,0,3,0,11,3,100,3.333333333
Kenya,1975,27,4,4,0,100,0,4,0,100,1,25,6.75
Kenya,1976,0,2,0,2,0,0,2,0,0,0,0,0
Kenya,1978,4,1,1,0,100,0,1,0,0,1,100,4
Kenya,1980,15,1,1,0,100,0,1,0,85,1,100,15
Kenya,1989,4,4,4,0,100,0,4,0,5,1,25,1
Kenya,1991,0,5,5,0,100,0,5,0,0,0,0,0
Kenya,1992,155,30,28,2,93.33333333,0,30,0,62,11,36.66666667,5.166666667
Kenya,1994,40,5,4,1,80,0,5,0,1,4,80,8
Kenya,1995,2,4,2,2,50,0,4,0,2,1,25,0.5
Kenya,1996,2,3,3,0,100,0,3,0,0,1,33.33333333,0.666666667
Kenya,1997,36,17,17,0,100,0,17,0,21,12,70.58823529,2.117647059
Kenya,1998,226,2,2,0,100,1,1,50,4000,2,100,113
Kenya,2000,26,4,4,0,100,0,4,0,5,2,50,6.5
Kenya,2001,13,7,5,2,71.42857143,0,7,0,8,3,42.85714286,1.857142857
Kenya,2002,16,2,1,1,50,1,1,50,0,1,50,8
Kenya,2003,3,2,2,0,100,0,2,0,0,2,100,1.5
Kenya,2005,56,2,2,0,100,0,2,0,0,2,100,28
Kenya,2006,18,2,2,0,100,0,2,0,6,2,100,9
Kenya,2007,33,12,12,0,100,1,11,8.333333333,48,10,83.33333333,2.75
Kenya,2008,103,11,10,1,90.90909091,0,11,0,3,7,63.63636364,9.363636364
Kenya,2009,0,1,1,0,100,0,1,0,0,0,0,0
Kenya,2010,19,12,12,0,100,0,12,0,159,9,75,1.583333333
Kenya,2011,42,42,35,7,83.33333333,0,42,0,112,21,50,1
Kenya,2012,107,80,72,8,90,0,80,0,421,42,52.5,1.3375
Kenya,2013,207,80,72,8,90,1,79,1.25,446,44,55,2.5875
Kenya,2014,315,115,103,12,89.56521739,0,115,0,408,55,47.82608696,2.739130435
Kenya,2015,281,71,56,15,78.87323944,1,70,1.408450704,205,36,50.70422535,3.957746479
Kenya,2016,72,65,56,9,86.15384615,1,64,1.538461538,69,25,38.46153846,1.107692308
Kenya,2017,126,97,92,5,94.84536082,0,97,0,97,45,46.39175258,1.298969072
Kosovo,1999,23,39,36,3,92.30769231,0,39,0,146,12,30.76923077,0.58974359
Kosovo,2000,23,60,54,6,90,0,60,0,84,16,26.66666667,0.383333333
Kosovo,2001,20,17,14,3,82.35294118,0,17,0,59,7,41.17647059,1.176470588
Kosovo,2002,1,5,5,0,100,0,5,0,32,1,20,0.2
Kosovo,2003,7,9,9,0,100,0,9,0,4,3,33.33333333,0.777777778
Kosovo,2004,0,1,1,0,100,0,1,0,5,0,0,0
Kosovo,2005,1,8,6,2,75,0,8,0,0,1,12.5,0.125
Kosovo,2006,0,6,6,0,100,0,6,0,4,0,0,0
Kosovo,2007,1,5,4,1,80,0,5,0,0,1,20,0.2
Kosovo,2008,0,11,9,2,81.81818182,0,11,0,5,0,0,0
Kosovo,2009,0,1,0,1,0,0,1,0,0,0,0,0
Kosovo,2010,1,1,1,0,100,0,1,0,11,1,100,1
Kosovo,2011,0,1,1,0,100,0,1,0,0,0,0,0
Kosovo,2012,3,4,4,0,100,0,4,0,4,2,50,0.75
Kosovo,2013,1,6,5,1,83.33333333,0,6,0,4,1,16.66666667,0.166666667
Kosovo,2014,2,4,3,1,75,0,4,0,3,2,50,0.5
Kosovo,2015,0,2,2,0,100,0,2,0,0,0,0,0
Kosovo,2016,0,8,5,3,62.5,0,8,0,0,0,0,0
Kosovo,2017,0,8,7,1,87.5,0,8,0,4,0,0,0
Kuwait,1972,0,1,1,0,100,0,1,0,0,0,0,0
Kuwait,1974,0,1,1,0,100,0,1,0,0,0,0,0
Kuwait,1975,0,1,1,0,100,0,1,0,0,0,0,0
Kuwait,1976,0,1,1,0,100,0,1,0,0,0,0,0
Kuwait,1978,1,1,1,0,100,0,1,0,0,1,100,1
Kuwait,1980,0,4,3,1,75,0,4,0,0,0,0,0
Kuwait,1981,2,3,3,0,100,0,3,0,0,2,66.66666667,0.666666667
Kuwait,1982,0,1,0,1,0,0,1,0,1,0,0,0
Kuwait,1983,1,7,7,0,100,1,6,14.28571429,13,1,14.28571429,0.142857143
Kuwait,1984,4,1,1,0,100,0,1,0,2,1,100,4
Kuwait,1985,11,2,2,0,100,0,2,0,18,1,50,5.5
Kuwait,1986,0,1,1,0,100,0,1,0,1,0,0,0
Kuwait,1987,1,12,10,2,83.33333333,0,12,0,0,1,8.333333333,0.083333333
Kuwait,1988,2,4,3,1,75,0,4,0,1,1,25,0.5
Kuwait,1991,1,5,4,1,80,0,5,0,1,1,20,0.2
Kuwait,1992,2,15,11,4,73.33333333,0,15,0,11,2,13.33333333,0.133333333
Kuwait,1994,0,2,2,0,100,0,2,0,3,0,0,0
Kuwait,1997,0,2,1,1,50,0,2,0,2,0,0,0
Kuwait,2001,2,2,2,0,100,0,2,0,1,2,100,1
Kuwait,2002,4,1,1,0,100,0,1,0,0,1,100,4
Kuwait,2003,1,3,3,0,100,0,3,0,18,1,33.33333333,0.333333333
Kuwait,2005,2,2,2,0,100,0,2,0,0,1,50,1
Kuwait,2011,0,1,0,1,0,0,1,0,0,0,0,0
Kuwait,2015,28,1,1,0,100,1,0,100,227,1,100,28
Kuwait,2016,1,2,1,1,50,1,1,50,1,1,50,0.5
Kyrgyzstan,1996,0,5,5,0,100,0,5,0,0,0,0,0
Kyrgyzstan,1999,1,3,3,0,100,0,3,0,7,1,33.33333333,0.333333333
Kyrgyzstan,2000,2,4,4,0,100,0,4,0,4,2,50,0.5
Kyrgyzstan,2001,0,1,1,0,100,0,1,0,0,0,0,0
Kyrgyzstan,2002,2,2,2,0,100,0,2,0,1,1,50,1
Kyrgyzstan,2003,1,1,1,0,100,0,1,0,0,1,100,1
Kyrgyzstan,2005,0,2,1,1,50,0,2,0,0,0,0,0
Kyrgyzstan,2006,1,3,1,2,33.33333333,0,3,0,2,1,33.33333333,0.333333333
Kyrgyzstan,2007,0,1,1,0,100,0,1,0,1,0,0,0
Kyrgyzstan,2010,0,1,1,0,100,0,1,0,4,0,0,0
Kyrgyzstan,2011,0,1,0,1,0,0,1,0,0,0,0,0
Kyrgyzstan,2014,1,2,1,1,50,0,2,0,1,1,50,0.5
Kyrgyzstan,2015,1,3,2,1,66.66666667,0,3,0,1,1,33.33333333,0.333333333
Kyrgyzstan,2016,1,4,2,2,50,1,3,25,5,1,25,0.25
Kyrgyzstan,2017,0,2,2,0,100,0,2,0,0,0,0,0
Laos,1989,2,1,1,0,100,0,1,0,0,1,100,2
Laos,1990,0,1,1,0,100,0,1,0,0,0,0,0
Laos,1992,3,4,4,0,100,0,4,0,0,2,50,0.75
Laos,1994,2,1,1,0,100,0,1,0,1,1,100,2
Laos,1996,5,1,1,0,100,0,1,0,1,1,100,5
Laos,2000,1,8,7,1,87.5,0,8,0,47,1,12.5,0.125
Laos,2001,0,1,1,0,100,0,1,0,9,0,0,0
Laos,2003,10,2,2,0,100,0,2,0,0,1,50,5
Laos,2012,0,1,0,1,0,0,1,0,0,0,0,0
Laos,2015,0,2,1,1,50,0,2,0,0,0,0,0
Laos,2016,3,4,4,0,100,0,4,0,15,2,50,0.75
Laos,2017,1,1,1,0,100,0,1,0,0,1,100,1
Latvia,1992,0,2,2,0,100,0,2,0,1,0,0,0
Latvia,1994,1,2,1,1,50,0,2,0,0,1,50,0.5
Latvia,1995,0,1,1,0,100,0,1,0,0,0,0,0
Latvia,1997,0,2,1,1,50,0,2,0,0,0,0,0
Latvia,1998,0,4,3,1,75,0,4,0,0,0,0,0
Latvia,1999,0,1,1,0,100,0,1,0,0,0,0,0
Latvia,2000,1,3,2,1,66.66666667,0,3,0,34,1,33.33333333,0.333333333
Latvia,2007,0,1,1,0,100,0,1,0,1,0,0,0
Latvia,2017,0,1,1,0,100,0,1,0,0,0,0,0
Lebanon,1970,0,1,1,0,100,0,1,0,0,0,0,0
Lebanon,1971,0,1,1,0,100,0,1,0,0,0,0,0
Lebanon,1972,0,3,3,0,100,0,3,0,0,0,0,0
Lebanon,1973,4,11,10,1,90.90909091,0,11,0,0,1,9.090909091,0.363636364
Lebanon,1974,0,11,9,2,81.81818182,0,11,0,10,0,0,0
Lebanon,1975,28,15,15,0,100,0,15,0,29,3,20,1.866666667
Lebanon,1976,4,4,3,1,75,0,4,0,1,2,50,1
Lebanon,1977,3,4,2,2,50,0,4,0,1,1,25,0.75
Lebanon,1978,107,12,8,4,66.66666667,0,12,0,173,5,41.66666667,8.916666667
Lebanon,1979,33,38,32,6,84.21052632,0,38,0,94,14,36.84210526,0.868421053
Lebanon,1980,90,86,64,22,74.41860465,0,86,0,267,32,37.20930233,1.046511628
Lebanon,1981,264,81,64,17,79.01234568,1,80,1.234567901,745,32,39.50617284,3.259259259
Lebanon,1982,234,120,106,14,88.33333333,1,119,0.833333333,459,49,40.83333333,1.95
Lebanon,1983,615,234,220,14,94.01709402,4,230,1.709401709,1005,68,29.05982906,2.628205128
Lebanon,1984,61,166,156,10,93.97590361,2,164,1.204819277,241,29,17.46987952,0.36746988
Lebanon,1985,644,95,93,2,97.89473684,15,80,15.78947368,1530,42,44.21052632,6.778947368
Lebanon,1986,247,106,104,2,98.11320755,3,103,2.830188679,1018,52,49.05660377,2.330188679
Lebanon,1987,178,94,85,9,90.42553191,2,92,2.127659574,338,38,40.42553191,1.893617021
Lebanon,1988,176,125,105,20,84,2,123,1.6,601,42,33.6,1.408
Lebanon,1989,113,141,133,8,94.32624113,0,141,0,364,41,29.07801418,0.80141844
Lebanon,1990,113,84,66,18,78.57142857,1,83,1.19047619,191,41,48.80952381,1.345238095
Lebanon,1991,98,91,82,9,90.10989011,0,91,0,386,36,39.56043956,1.076923077
Lebanon,1992,79,91,78,13,85.71428571,0,91,0,116,45,49.45054945,0.868131868
Lebanon,1994,57,67,57,10,85.07462687,0,67,0,127,28,41.79104478,0.850746269
Lebanon,1995,35,38,36,2,94.73684211,0,38,0,72,20,52.63157895,0.921052632
Lebanon,1996,57,39,36,3,92.30769231,1,38,2.564102564,70,24,61.53846154,1.461538462
Lebanon,1997,36,46,44,2,95.65217391,1,45,2.173913043,50,24,52.17391304,0.782608696
Lebanon,1998,17,23,20,3,86.95652174,1,22,4.347826087,48,10,43.47826087,0.739130435
Lebanon,1999,23,42,37,5,88.0952381,1,41,2.380952381,48,15,35.71428571,0.547619048
Lebanon,2000,12,12,10,2,83.33333333,0,12,0,12,7,58.33333333,1
Lebanon,2001,0,5,5,0,100,0,5,0,3,0,0,0
Lebanon,2002,2,8,8,0,100,0,8,0,4,2,25,0.25
Lebanon,2003,3,5,4,1,80,0,5,0,1,2,40,0.6
Lebanon,2004,1,1,1,0,100,0,1,0,2,1,100,1
Lebanon,2005,22,17,14,3,82.35294118,0,17,0,58,6,35.29411765,1.294117647
Lebanon,2006,17,8,8,0,100,1,7,12.5,10,5,62.5,2.125
Lebanon,2007,40,18,17,1,94.44444444,1,17,5.555555556,148,10,55.55555556,2.222222222
Lebanon,2008,142,58,52,6,89.65517241,1,57,1.724137931,490,27,46.55172414,2.448275862
Lebanon,2009,17,14,13,1,92.85714286,0,14,0,21,5,35.71428571,1.214285714
Lebanon,2010,2,5,4,1,80,0,5,0,6,1,20,0.4
Lebanon,2011,1,10,10,0,100,0,10,0,23,1,10,0.1
Lebanon,2012,9,15,9,6,60,0,15,0,92,2,13.33333333,0.6
Lebanon,2013,190,121,104,17,85.95041322,6,115,4.958677686,1048,30,24.79338843,1.570247934
Lebanon,2014,134,204,168,36,82.35294118,13,191,6.37254902,532,54,26.47058824,0.656862745
Lebanon,2015,111,44,33,11,75,4,40,9.090909091,347,16,36.36363636,2.522727273
Lebanon,2016,25,41,35,6,85.36585366,2,39,4.87804878,74,12,29.26829268,0.609756098
Lebanon,2017,17,23,17,6,73.91304348,2,21,8.695652174,49,7,30.43478261,0.739130435
Lesotho,1979,0,2,2,0,100,0,2,0,0,0,0,0
Lesotho,1981,10,5,5,0,100,0,5,0,6,1,20,2
Lesotho,1982,0,2,0,2,0,0,2,0,5,0,0,0
Lesotho,1983,30,12,10,2,83.33333333,0,12,0,8,5,41.66666667,2.5
Lesotho,1984,1,1,1,0,100,0,1,0,1,1,100,1
Lesotho,1988,4,1,1,0,100,0,1,0,11,1,100,4
Lesotho,1994,0,3,3,0,100,0,3,0,0,0,0,0
Lesotho,2006,0,1,1,0,100,0,1,0,1,0,0,0
Lesotho,2009,0,1,1,0,100,0,1,0,0,0,0,0
Lesotho,2015,1,1,1,0,100,0,1,0,2,1,100,1
Liberia,1990,2,4,4,0,100,0,4,0,0,1,25,0.5
Liberia,1991,0,1,1,0,100,0,1,0,0,0,0,0
Liberia,1992,37,10,10,0,100,0,10,0,28,7,70,3.7
Liberia,1994,110,3,3,0,100,0,3,0,0,2,66.66666667,36.66666667
Liberia,1996,10,1,1,0,100,0,1,0,0,1,100,10
Liberia,1999,0,2,2,0,100,0,2,0,0,0,0,0
Liberia,2000,0,1,1,0,100,0,1,0,8,0,0,0
Liberia,2001,1,3,3,0,100,0,3,0,0,1,33.33333333,0.333333333
Liberia,2002,3,3,3,0,100,0,3,0,0,1,33.33333333,1
Liberia,2003,2,2,2,0,100,0,2,0,0,1,50,1
Liberia,2008,12,1,1,0,100,0,1,0,0,1,100,12
Liberia,2012,0,1,0,1,0,0,1,0,0,0,0,0
Liberia,2014,0,1,1,0,100,0,1,0,0,0,0,0
Liberia,2017,0,1,0,1,0,0,1,0,0,0,0,0
Libya,1979,0,3,2,1,66.66666667,0,3,0,1,0,0,0
Libya,1980,0,2,2,0,100,0,2,0,0,0,0,0
Libya,1984,15,3,2,1,66.66666667,0,3,0,1,1,33.33333333,5
Libya,1992,0,1,1,0,100,0,1,0,0,0,0,0
Libya,1995,0,1,0,1,0,0,1,0,0,0,0,0
Libya,1996,12,4,3,1,75,0,4,0,0,3,75,3
Libya,2007,0,1,1,0,100,0,1,0,0,0,0,0
Libya,2008,0,1,1,0,100,0,1,0,0,0,0,0
Libya,2011,0,2,2,0,100,0,2,0,2,0,0,0
Libya,2012,33,57,49,8,85.96491228,0,57,0,37,21,36.84210526,0.578947368
Libya,2013,232,291,255,36,87.62886598,2,289,0.687285223,618,125,42.95532646,0.797250859
Libya,2014,694,728,661,67,90.7967033,14,714,1.923076923,895,268,36.81318681,0.953296703
Libya,2015,689,543,489,54,90.05524862,28,515,5.156537753,841,204,37.56906077,1.268876611
Libya,2016,634,422,368,54,87.20379147,56,366,13.27014218,744,185,43.83886256,1.502369668
Libya,2017,289,190,150,40,78.94736842,9,181,4.736842105,171,72,37.89473684,1.521052632
Lithuania,1991,0,1,1,0,100,0,1,0,1,0,0,0
Lithuania,1992,0,1,1,0,100,0,1,0,0,0,0,0
Lithuania,1995,0,2,2,0,100,0,2,0,0,0,0,0
Lithuania,1996,0,3,2,1,66.66666667,0,3,0,1,0,0,0
Lithuania,1997,1,1,1,0,100,0,1,0,0,1,100,1
Luxembourg,1983,0,2,0,2,0,0,2,0,0,0,0,0
Luxembourg,1985,0,10,10,0,100,0,10,0,6,0,0,0
Luxembourg,1986,0,1,1,0,100,0,1,0,0,0,0,0
Luxembourg,1994,0,3,3,0,100,0,3,0,0,0,0,0
Macau,1995,0,1,1,0,100,0,1,0,0,0,0,0
Macau,1996,0,10,8,2,80,0,10,0,17,0,0,0
Macau,1997,1,16,12,4,75,0,16,0,14,1,6.25,0.0625
Macau,1998,0,6,6,0,100,0,6,0,15,0,0,0
Macedonia,1994,0,1,1,0,100,0,1,0,0,0,0,0
Macedonia,1995,1,1,0,1,0,0,1,0,6,1,100,1
Macedonia,1997,0,2,2,0,100,0,2,0,0,0,0,0
Macedonia,1998,0,5,5,0,100,0,5,0,0,0,0,0
Macedonia,1999,0,3,3,0,100,0,3,0,0,0,0,0
Macedonia,2000,3,3,3,0,100,0,3,0,0,1,33.33333333,1
Macedonia,2001,35,67,58,9,86.56716418,0,67,0,29,13,19.40298507,0.52238806
Macedonia,2002,3,8,7,1,87.5,0,8,0,4,2,25,0.375
Macedonia,2003,0,5,5,0,100,0,5,0,1,0,0,0
Macedonia,2006,0,3,3,0,100,0,3,0,0,0,0,0
Macedonia,2007,0,1,1,0,100,0,1,0,1,0,0,0
Macedonia,2008,2,9,9,0,100,0,9,0,11,2,22.22222222,0.222222222
Macedonia,2009,0,1,1,0,100,0,1,0,1,0,0,0
Macedonia,2012,5,1,1,0,100,0,1,0,0,1,100,5
Macedonia,2014,0,3,3,0,100,0,3,0,5,0,0,0
Macedonia,2015,0,4,4,0,100,0,4,0,2,0,0,0
Macedonia,2017,0,1,1,0,100,0,1,0,0,0,0,0
Madagascar,1991,4,1,1,0,100,0,1,0,0,1,100,4
Madagascar,1992,16,7,5,2,71.42857143,0,7,0,58,2,28.57142857,2.285714286
Madagascar,1995,4,3,3,0,100,0,3,0,0,1,33.33333333,1.333333333
Madagascar,1996,1,2,1,1,50,0,2,0,1,1,50,0.5
Madagascar,1997,0,1,1,0,100,0,1,0,1,0,0,0
Madagascar,2002,0,5,5,0,100,0,5,0,0,0,0,0
Madagascar,2006,0,1,1,0,100,0,1,0,0,0,0,0
Madagascar,2009,2,1,1,0,100,0,1,0,0,1,100,2
Madagascar,2011,0,1,0,1,0,0,1,0,0,0,0,0
Madagascar,2012,0,1,1,0,100,0,1,0,3,0,0,0
Madagascar,2013,0,2,2,0,100,0,2,0,0,0,0,0
Madagascar,2014,1,1,1,0,100,0,1,0,31,1,100,1
Madagascar,2016,3,1,1,0,100,0,1,0,91,1,100,3
Malawi,1992,32,3,3,0,100,0,3,0,0,2,66.66666667,10.66666667
Malawi,2002,1,1,1,0,100,0,1,0,0,1,100,1
Malawi,2017,0,1,1,0,100,0,1,0,0,0,0,0
Malaysia,1973,0,1,1,0,100,0,1,0,8,0,0,0
Malaysia,1975,0,3,3,0,100,0,3,0,3,0,0,0
Malaysia,1977,100,2,2,0,100,0,2,0,1,1,50,50
Malaysia,1979,5,1,1,0,100,0,1,0,0,1,100,5
Malaysia,1983,0,1,1,0,100,0,1,0,0,0,0,0
Malaysia,1986,20,15,15,0,100,0,15,0,54,12,80,1.333333333
Malaysia,1988,9,4,4,0,100,0,4,0,2,2,50,2.25
Malaysia,1989,0,2,2,0,100,0,2,0,8,0,0,0
Malaysia,1990,0,3,3,0,100,0,3,0,3,0,0,0
Malaysia,1991,0,3,2,1,66.66666667,0,3,0,1,0,0,0
Malaysia,1992,0,2,1,1,50,0,2,0,0,0,0,0
Malaysia,2000,2,3,2,1,66.66666667,0,3,0,0,1,33.33333333,0.666666667
Malaysia,2001,0,1,1,0,100,0,1,0,2,0,0,0
Malaysia,2008,0,2,2,0,100,0,2,0,0,0,0,0
Malaysia,2009,0,1,1,0,100,0,1,0,1,0,0,0
Malaysia,2012,2,2,2,0,100,0,2,0,1,2,100,1
Malaysia,2013,2,13,10,3,76.92307692,0,13,0,1,2,15.38461538,0.153846154
Malaysia,2014,1,12,9,3,75,0,12,0,4,1,8.333333333,0.083333333
Malaysia,2015,1,5,5,0,100,0,5,0,1,1,20,0.2
Malaysia,2016,6,19,17,2,89.47368421,0,19,0,9,3,15.78947368,0.315789474
Malaysia,2017,4,4,2,2,50,0,4,0,2,1,25,1
Maldives,1988,19,1,1,0,100,0,1,0,100,1,100,19
Maldives,2006,0,1,1,0,100,0,1,0,1,0,0,0
Maldives,2007,0,1,1,0,100,0,1,0,12,0,0,0
Maldives,2008,0,1,0,1,0,0,1,0,0,0,0,0
Maldives,2012,0,1,0,1,0,0,1,0,1,0,0,0
Maldives,2013,0,3,3,0,100,0,3,0,2,0,0,0
Maldives,2014,0,9,9,0,100,0,9,0,0,0,0,0
Maldives,2015,0,2,0,2,0,0,2,0,3,0,0,0
Maldives,2016,0,1,1,0,100,0,1,0,3,0,0,0
Maldives,2017,1,2,2,0,100,0,2,0,0,1,50,0.5
Mali,1990,14,1,1,0,100,0,1,0,1,1,100,14
Mali,1991,43,12,12,0,100,0,12,0,19,10,83.33333333,3.583333333
Mali,1992,5,3,3,0,100,0,3,0,0,2,66.66666667,1.666666667
Mali,1994,131,13,13,0,100,0,13,0,46,10,76.92307692,10.07692308
Mali,1995,2,1,1,0,100,0,1,0,6,1,100,2
Mali,1997,0,3,3,0,100,0,3,0,3,0,0,0
Mali,2005,0,1,1,0,100,0,1,0,0,0,0,0
Mali,2007,20,5,5,0,100,0,5,0,0,2,40,4
Mali,2008,55,9,8,1,88.88888889,0,9,0,53,5,55.55555556,6.111111111
Mali,2009,30,6,6,0,100,0,6,0,0,3,50,5
Mali,2010,1,1,1,0,100,0,1,0,0,1,100,1
Mali,2011,5,4,4,0,100,0,4,0,2,3,75,1.25
Mali,2012,53,19,18,1,94.73684211,0,19,0,45,6,31.57894737,2.789473684
Mali,2013,137,58,56,2,96.55172414,18,40,31.03448276,138,35,60.34482759,2.362068966
Mali,2014,125,69,66,3,95.65217391,4,65,5.797101449,225,26,37.68115942,1.811594203
Mali,2015,269,121,111,10,91.73553719,6,115,4.958677686,251,66,54.54545455,2.223140496
Mali,2016,181,99,90,9,90.90909091,3,96,3.03030303,220,60,60.60606061,1.828282828
Mali,2017,361,141,124,17,87.94326241,1,140,0.709219858,347,85,60.28368794,2.560283688
Malta,1977,1,1,1,0,100,0,1,0,0,1,100,1
Malta,1984,0,7,6,1,85.71428571,0,7,0,0,0,0,0
Malta,1985,0,1,1,0,100,0,1,0,0,0,0,0
Malta,1986,1,1,1,0,100,0,1,0,0,1,100,1
Malta,1987,0,4,4,0,100,0,4,0,11,0,0,0
Malta,1992,1,1,1,0,100,0,1,0,0,1,100,1
Malta,1995,1,2,2,0,100,0,2,0,1,1,50,0.5
Malta,1997,0,1,1,0,100,0,1,0,0,0,0,0
Malta,2014,0,1,1,0,100,0,1,0,0,0,0,0
Malta,2015,0,1,1,0,100,0,1,0,0,0,0,0
Malta,2017,1,3,3,0,100,0,3,0,0,1,33.33333333,0.333333333
Martinique,1981,0,1,1,0,100,0,1,0,0,0,0,0
Martinique,1983,0,5,5,0,100,0,5,0,0,0,0,0
Martinique,1984,0,2,2,0,100,0,2,0,0,0,0,0
Martinique,1987,0,1,1,0,100,0,1,0,0,0,0,0
Martinique,1988,0,1,1,0,100,0,1,0,1,0,0,0
Martinique,1991,0,1,1,0,100,0,1,0,0,0,0,0
Martinique,1992,0,1,1,0,100,0,1,0,0,0,0,0
Mauritania,1977,4,4,4,0,100,0,4,0,0,2,50,1
Mauritania,1996,0,1,0,1,0,0,1,0,0,0,0,0
Mauritania,2004,0,1,1,0,100,0,1,0,0,0,0,0
Mauritania,2005,23,1,1,0,100,0,1,0,20,1,100,23
Mauritania,2008,12,2,1,1,50,0,2,0,0,1,50,6
Mauritania,2009,2,5,4,1,80,1,4,20,4,2,40,0.4
Mauritania,2010,1,1,1,0,100,1,0,100,0,1,100,1
Mauritania,2011,1,3,2,1,66.66666667,1,2,33.33333333,4,1,33.33333333,0.333333333
Mauritius,1988,0,1,0,1,0,0,1,0,1,0,0,0
Mauritius,1989,0,1,0,1,0,0,1,0,0,0,0,0
Mexico,1970,0,2,2,0,100,0,2,0,0,0,0,0
Mexico,1972,0,1,1,0,100,0,1,0,0,0,0,0
Mexico,1973,1,6,6,0,100,0,6,0,0,1,16.66666667,0.166666667
Mexico,1974,2,16,16,0,100,0,16,0,0,2,12.5,0.125
Mexico,1975,32,10,9,1,90,0,10,0,5,6,60,3.2
Mexico,1976,26,20,18,2,90,0,20,0,5,11,55,1.3
Mexico,1977,11,19,17,2,89.47368421,0,19,0,15,4,21.05263158,0.578947368
Mexico,1978,7,30,29,1,96.66666667,0,30,0,18,6,20,0.233333333
Mexico,1979,5,10,9,1,90,0,10,0,0,5,50,0.5
Mexico,1980,3,5,5,0,100,0,5,0,0,2,40,0.6
Mexico,1981,0,3,3,0,100,0,3,0,6,0,0,0
Mexico,1982,1,3,1,2,33.33333333,0,3,0,0,1,33.33333333,0.333333333
Mexico,1983,0,2,0,2,0,0,2,0,2,0,0,0
Mexico,1984,13,4,4,0,100,0,4,0,9,3,75,3.25
Mexico,1985,0,1,1,0,100,0,1,0,0,0,0,0
Mexico,1986,0,2,1,1,50,0,2,0,0,0,0,0
Mexico,1987,0,1,1,0,100,0,1,0,0,0,0,0
Mexico,1988,2,3,3,0,100,0,3,0,0,1,33.33333333,0.666666667
Mexico,1989,0,1,1,0,100,0,1,0,0,0,0,0
Mexico,1990,3,5,4,1,80,0,5,0,1,2,40,0.6
Mexico,1991,13,10,10,0,100,0,10,0,0,3,30,1.3
Mexico,1992,6,6,5,1,83.33333333,0,6,0,2,3,50,1
Mexico,1994,88,42,41,1,97.61904762,0,42,0,32,15,35.71428571,2.095238095
Mexico,1995,61,29,26,3,89.65517241,0,29,0,27,15,51.72413793,2.103448276
Mexico,1996,96,75,70,5,93.33333333,0,75,0,211,40,53.33333333,1.28
Mexico,1997,229,95,91,4,95.78947368,0,95,0,47,55,57.89473684,2.410526316
Mexico,1998,3,2,2,0,100,0,2,0,5,1,50,1.5
Mexico,1999,0,1,1,0,100,0,1,0,2,0,0,0
Mexico,2000,5,4,4,0,100,0,4,0,3,2,50,1.25
Mexico,2001,13,7,6,1,85.71428571,0,7,0,5,2,28.57142857,1.857142857
Mexico,2003,2,1,1,0,100,0,1,0,1,1,100,2
Mexico,2004,0,1,0,1,0,0,1,0,3,0,0,0
Mexico,2005,2,1,1,0,100,0,1,0,0,1,100,2
Mexico,2006,7,7,7,0,100,0,7,0,34,4,57.14285714,1
Mexico,2007,25,10,10,0,100,0,10,0,6,8,80,2.5
Mexico,2008,21,8,7,1,87.5,1,7,12.5,104,6,75,2.625
Mexico,2009,2,1,0,1,0,0,1,0,3,1,100,2
Mexico,2010,0,5,3,2,60,0,5,0,0,0,0,0
Mexico,2011,0,2,2,0,100,0,2,0,1,0,0,0
Mexico,2012,17,16,15,1,93.75,0,16,0,8,7,43.75,1.0625
Mexico,2013,47,8,8,0,100,0,8,0,110,4,50,5.875
Mexico,2014,1,5,4,1,80,0,5,0,2,1,20,0.2
Mexico,2015,9,19,14,5,73.68421053,0,19,0,10,7,36.84210526,0.473684211
Mexico,2016,4,5,4,1,80,0,5,0,0,4,80,0.8
Mexico,2017,23,20,16,4,80,0,20,0,6,15,75,1.15
Middle East & North Africa,1970,1,28,23,5,82.14285714,0,28,0,5,1,3.571428571,0.035714286
Middle East & North Africa,1971,7,55,49,6,89.09090909,0,55,0,11,5,9.090909091,0.127272727
Middle East & North Africa,1972,33,53,27,26,50.94339623,0,53,0,83,6,11.32075472,0.622641509
Middle East & North Africa,1973,7,19,15,4,78.94736842,0,19,0,18,3,15.78947368,0.368421053
Middle East & North Africa,1974,81,42,39,3,92.85714286,0,42,0,168,11,26.19047619,1.928571429
Middle East & North Africa,1975,60,44,43,1,97.72727273,0,44,0,92,12,27.27272727,1.363636364
Middle East & North Africa,1976,45,55,51,4,92.72727273,0,55,0,388,14,25.45454545,0.818181818
Middle East & North Africa,1977,43,211,198,13,93.83886256,0,211,0,115,31,14.69194313,0.203791469
Middle East & North Africa,1978,671,128,114,14,89.0625,0,128,0,641,47,36.71875,5.2421875
Middle East & North Africa,1979,366,455,383,72,84.17582418,0,455,0,953,155,34.06593407,0.804395604
Middle East & North Africa,1980,442,437,353,84,80.77803204,0,437,0,1019,165,37.75743707,1.011441648
Middle East & North Africa,1981,772,312,251,61,80.44871795,1,311,0.320512821,1425,130,41.66666667,2.474358974
Middle East & North Africa,1982,587,290,243,47,83.79310345,1,289,0.344827586,1738,93,32.06896552,2.024137931
Middle East & North Africa,1983,756,334,300,34,89.82035928,5,329,1.497005988,1145,83,24.8502994,2.263473054
Middle East & North Africa,1984,149,268,235,33,87.68656716,2,266,0.746268657,763,52,19.40298507,0.555970149
Middle East & North Africa,1985,723,133,128,5,96.2406015,16,117,12.03007519,1684,52,39.09774436,5.436090226
Middle East & North Africa,1986,409,196,185,11,94.3877551,3,193,1.530612245,1401,82,41.83673469,2.086734694
Middle East & North Africa,1987,581,202,178,24,88.11881188,2,200,0.99009901,516,82,40.59405941,2.876237624
Middle East & North Africa,1988,365,246,203,43,82.5203252,2,244,0.81300813,807,85,34.55284553,1.483739837
Middle East & North Africa,1989,480,465,418,47,89.89247312,1,464,0.215053763,564,204,43.87096774,1.032258065
Middle East & North Africa,1990,778,494,424,70,85.82995951,1,493,0.20242915,670,275,55.66801619,1.574898785
Middle East & North Africa,1991,544,612,546,66,89.21568627,0,612,0,892,229,37.41830065,0.888888889
Middle East & North Africa,1992,1879,1192,1039,153,87.16442953,0,1192,0,1468,637,53.43959732,1.576342282
Middle East & North Africa,1994,2065,1051,936,115,89.05803996,6,1045,0.570884872,1982,564,53.66317793,1.964795433
Middle East & North Africa,1995,1020,590,533,57,90.33898305,7,583,1.186440678,2205,349,59.15254237,1.728813559
Middle East & North Africa,1996,961,373,346,27,92.7613941,9,364,2.412868633,2085,233,62.46648794,2.576407507
Middle East & North Africa,1997,4691,548,525,23,95.80291971,5,543,0.912408759,2582,410,74.81751825,8.560218978
Middle East & North Africa,1998,1079,247,234,13,94.73684211,7,240,2.834008097,1291,155,62.75303644,4.368421053
Middle East & North Africa,1999,672,316,292,24,92.40506329,15,301,4.746835443,877,178,56.32911392,2.126582278
Middle East & North Africa,2000,624,272,253,19,93.01470588,6,266,2.205882353,586,165,60.66176471,2.294117647
Middle East & North Africa,2001,907,362,332,30,91.71270718,31,331,8.563535912,1424,214,59.1160221,2.505524862
Middle East & North Africa,2002,1175,326,299,27,91.71779141,62,264,19.01840491,2157,238,73.00613497,3.604294479
Middle East & North Africa,2003,1063,310,281,29,90.64516129,65,245,20.96774194,3252,213,68.70967742,3.429032258
Middle East & North Africa,2004,2558,492,470,22,95.52845528,94,398,19.10569106,5267,352,71.54471545,5.199186992
Middle East & North Africa,2005,3918,882,837,45,94.89795918,180,702,20.40816327,7220,641,72.67573696,4.442176871
Middle East & North Africa,2006,5032,1187,1150,37,96.88289806,109,1078,9.182813816,9198,776,65.37489469,4.239258635
Middle East & North Africa,2007,7180,1385,1338,47,96.60649819,223,1162,16.10108303,14709,919,66.35379061,5.184115523
Middle East & North Africa,2008,3467,1536,1446,90,94.140625,126,1410,8.203125,8545,794,51.69270833,2.257161458
Middle East & North Africa,2009,2982,1361,1265,96,92.94636297,65,1296,4.775900073,9862,634,46.58339456,2.191036003
Middle East & North Africa,2010,2663,1463,1330,133,90.90909091,64,1399,4.374572796,7871,714,48.80382775,1.820232399
Middle East & North Africa,2011,2651,1663,1505,158,90.49909802,62,1601,3.728202044,6089,868,52.19482862,1.594107035
Middle East & North Africa,2012,5033,2409,2245,164,93.19219593,149,2260,6.185139062,10861,1348,55.95682856,2.089248651
Middle East & North Africa,2013,10164,4560,4145,415,90.89912281,353,4207,7.74122807,21496,2766,60.65789474,2.228947368
Middle East & North Africa,2014,20080,6939,6202,737,89.37887304,437,6502,6.297737426,22601,3654,52.65888457,2.89378873
Middle East & North Africa,2015,17854,6036,5167,869,85.60304838,523,5513,8.664678595,23757,3656,60.56991385,2.957919152
Middle East & North Africa,2016,19205,6115,4920,1195,80.45789043,691,5424,11.30008177,23433,3615,59.11692559,3.140637776
Middle East & North Africa,2017,10819,3780,2823,957,74.68253968,449,3331,11.87830688,8392,1950,51.58730159,2.862169312
Moldova,1991,0,1,1,0,100,0,1,0,0,0,0,0
Moldova,1992,10,11,11,0,100,0,11,0,39,4,36.36363636,0.909090909
Moldova,1994,1,1,1,0,100,0,1,0,0,1,100,1
Moldova,1996,0,2,2,0,100,0,2,0,0,0,0,0
Moldova,1997,0,1,1,0,100,0,1,0,0,0,0,0
Moldova,2000,0,1,0,1,0,0,1,0,0,0,0,0
Moldova,2006,2,1,1,0,100,0,1,0,10,1,100,2
Moldova,2009,0,1,1,0,100,0,1,0,39,0,0,0
Moldova,2012,0,1,0,1,0,0,1,0,0,0,0,0
Moldova,2016,0,1,0,1,0,0,1,0,0,0,0,0
Montenegro,2001,1,1,1,0,100,0,1,0,0,1,100,1
Montenegro,2007,0,1,1,0,100,0,1,0,0,0,0,0
Montenegro,2013,0,2,2,0,100,0,2,0,0,0,0,0
Montenegro,2015,0,1,1,0,100,0,1,0,0,0,0,0
Morocco,1973,0,2,0,2,0,0,2,0,0,0,0,0
Morocco,1976,0,1,1,0,100,0,1,0,0,0,0,0
Morocco,1978,10,1,1,0,100,0,1,0,0,1,100,10
Morocco,1979,0,2,2,0,100,0,2,0,34,0,0,0
Morocco,1985,0,2,2,0,100,0,2,0,0,0,0,0
Morocco,1986,2,2,2,0,100,0,2,0,2,2,100,1
Morocco,1987,200,4,4,0,100,0,4,0,0,4,100,50
Morocco,1991,3,3,3,0,100,0,3,0,0,3,100,1
Morocco,1992,2,1,1,0,100,0,1,0,0,1,100,2
Morocco,1994,0,2,2,0,100,0,2,0,0,0,0,0
Morocco,1995,0,1,1,0,100,0,1,0,1,0,0,0
Morocco,1996,0,2,1,1,50,0,2,0,13,0,0,0
Morocco,2003,45,5,5,0,100,5,0,100,100,5,100,9
Morocco,2007,13,6,6,0,100,6,0,100,26,6,100,2.166666667
Morocco,2011,17,1,1,0,100,0,1,0,24,1,100,17
Morocco,2015,0,1,1,0,100,0,1,0,0,0,0,0
Mozambique,1978,2,2,2,0,100,0,2,0,6,2,100,1
Mozambique,1979,34,5,5,0,100,0,5,0,0,2,40,6.8
Mozambique,1981,6,3,2,1,66.66666667,0,3,0,0,1,33.33333333,2
Mozambique,1982,18,9,9,0,100,0,9,0,50,2,22.22222222,2
Mozambique,1983,5,4,4,0,100,0,4,0,2,1,25,1.25
Mozambique,1984,56,10,8,2,80,0,10,0,94,5,50,5.6
Mozambique,1985,8,5,5,0,100,0,5,0,136,2,40,1.6
Mozambique,1986,470,7,7,0,100,0,7,0,17,3,42.85714286,67.14285714
Mozambique,1987,468,11,11,0,100,0,11,0,170,4,36.36363636,42.54545455
Mozambique,1988,145,16,16,0,100,0,16,0,163,8,50,9.0625
Mozambique,1989,710,64,64,0,100,0,64,0,275,51,79.6875,11.09375
Mozambique,1990,185,23,23,0,100,0,23,0,126,15,65.2173913,8.043478261
Mozambique,1991,271,35,35,0,100,0,35,0,169,27,77.14285714,7.742857143
Mozambique,1992,155,19,19,0,100,0,19,0,61,16,84.21052632,8.157894737
Mozambique,1994,0,3,3,0,100,0,3,0,0,0,0,0
Mozambique,1995,15,3,3,0,100,0,3,0,1,2,66.66666667,5
Mozambique,1999,0,1,1,0,100,0,1,0,1,0,0,0
Mozambique,2000,1,3,3,0,100,0,3,0,2,1,33.33333333,0.333333333
Mozambique,2007,6,1,1,0,100,0,1,0,3,1,100,6
Mozambique,2012,1,1,1,0,100,0,1,0,4,1,100,1
Mozambique,2013,37,18,18,0,100,0,18,0,80,12,66.66666667,2.055555556
Mozambique,2014,22,22,22,0,100,0,22,0,60,5,22.72727273,1
Mozambique,2015,12,8,5,3,62.5,0,8,0,3,3,37.5,1.5
Mozambique,2016,62,79,69,10,87.34177215,0,79,0,84,26,32.91139241,0.784810127
Mozambique,2017,22,11,10,1,90.90909091,0,11,0,11,9,81.81818182,2
Myanmar,1973,0,1,1,0,100,0,1,0,0,0,0,0
Myanmar,1976,0,2,2,0,100,0,2,0,0,0,0,0
Myanmar,1979,86,19,19,0,100,0,19,0,175,14,73.68421053,4.526315789
Myanmar,1980,6,1,1,0,100,0,1,0,8,1,100,6
Myanmar,1982,3,2,2,0,100,0,2,0,0,1,50,1.5
Myanmar,1983,21,4,3,1,75,0,4,0,50,1,25,5.25
Myanmar,1987,0,1,1,0,100,0,1,0,0,0,0,0
Myanmar,1988,93,23,22,1,95.65217391,0,23,0,247,12,52.17391304,4.043478261
Myanmar,1989,80,24,24,0,100,0,24,0,70,11,45.83333333,3.333333333
Myanmar,1990,71,9,9,0,100,0,9,0,51,5,55.55555556,7.888888889
Myanmar,1991,90,22,22,0,100,0,22,0,74,12,54.54545455,4.090909091
Myanmar,1992,139,12,12,0,100,0,12,0,64,10,83.33333333,11.58333333
Myanmar,1994,18,8,8,0,100,0,8,0,16,5,62.5,2.25
Myanmar,1995,30,12,12,0,100,0,12,0,29,6,50,2.5
Myanmar,1996,86,13,13,0,100,0,13,0,84,9,69.23076923,6.615384615
Myanmar,1997,16,35,34,1,97.14285714,0,35,0,10,2,5.714285714,0.457142857
Myanmar,1999,10,4,4,0,100,0,4,0,18,2,50,2.5
Myanmar,2001,8,3,3,0,100,0,3,0,5,3,100,2.666666667
Myanmar,2002,5,4,4,0,100,0,4,0,33,2,50,1.25
Myanmar,2003,18,9,7,2,77.77777778,0,9,0,51,7,77.77777778,2
Myanmar,2004,1,2,2,0,100,0,2,0,3,1,50,0.5
Myanmar,2005,21,8,8,0,100,0,8,0,178,4,50,2.625
Myanmar,2006,0,2,2,0,100,0,2,0,0,0,0,0
Myanmar,2007,10,3,3,0,100,0,3,0,5,1,33.33333333,3.333333333
Myanmar,2008,14,20,19,1,95,0,20,0,33,6,30,0.7
Myanmar,2009,46,14,13,1,92.85714286,0,14,0,15,4,28.57142857,3.285714286
Myanmar,2010,13,11,10,1,90.90909091,1,10,9.090909091,84,5,45.45454545,1.181818182
Myanmar,2011,0,2,2,0,100,0,2,0,0,0,0,0
Myanmar,2012,16,17,16,1,94.11764706,0,17,0,10,6,35.29411765,0.941176471
Myanmar,2013,11,18,16,2,88.88888889,0,18,0,29,7,38.88888889,0.611111111
Myanmar,2014,17,15,14,1,93.33333333,0,15,0,43,4,26.66666667,1.133333333
Myanmar,2015,60,37,36,1,97.2972973,0,37,0,153,12,32.43243243,1.621621622
Myanmar,2016,73,74,62,12,83.78378378,0,74,0,58,19,25.67567568,0.986486486
Myanmar,2017,218,115,103,12,89.56521739,0,115,0,35,61,53.04347826,1.895652174
Namibia,1975,1,1,1,0,100,0,1,0,0,1,100,1
Namibia,1976,3,2,2,0,100,0,2,0,0,2,100,1.5
Namibia,1978,2,8,8,0,100,0,8,0,65,2,25,0.25
Namibia,1979,32,31,30,1,96.77419355,0,31,0,35,14,45.16129032,1.032258065
Namibia,1980,2,2,2,0,100,0,2,0,3,2,100,1
Namibia,1982,2,2,2,0,100,0,2,0,0,1,50,1
Namibia,1983,4,5,5,0,100,0,5,0,0,1,20,0.8
Namibia,1984,26,24,24,0,100,0,24,0,42,11,45.83333333,1.083333333
Namibia,1985,74,8,8,0,100,0,8,0,26,5,62.5,9.25
Namibia,1986,5,1,1,0,100,0,1,0,23,1,100,5
Namibia,1987,2,7,7,0,100,0,7,0,3,2,28.57142857,0.285714286
Namibia,1988,25,17,16,1,94.11764706,0,17,0,80,6,35.29411765,1.470588235
Namibia,1989,1,11,10,1,90.90909091,0,11,0,7,1,9.090909091,0.090909091
Namibia,1990,0,2,2,0,100,0,2,0,0,0,0,0
Namibia,1991,3,1,1,0,100,0,1,0,3,1,100,3
Namibia,1994,0,1,0,1,0,0,1,0,0,0,0,0
Namibia,1999,13,1,1,0,100,0,1,0,25,1,100,13
Namibia,2000,24,21,21,0,100,0,21,0,85,11,52.38095238,1.142857143
Namibia,2001,1,6,6,0,100,0,6,0,9,1,16.66666667,0.166666667
Nepal,1985,6,9,8,1,88.88888889,0,9,0,22,2,22.22222222,0.666666667
Nepal,1991,0,1,1,0,100,0,1,0,0,0,0,0
Nepal,1992,9,8,6,2,75,0,8,0,46,4,50,1.125
Nepal,1994,4,3,3,0,100,0,3,0,15,2,66.66666667,1.333333333
Nepal,1996,6,5,5,0,100,0,5,0,7,1,20,1.2
Nepal,1997,15,9,9,0,100,0,9,0,8,7,77.77777778,1.666666667
Nepal,1999,23,8,8,0,100,0,8,0,14,6,75,2.875
Nepal,2000,91,23,22,1,95.65217391,0,23,0,160,13,56.52173913,3.956521739
Nepal,2001,172,33,31,2,93.93939394,0,33,0,59,17,51.51515152,5.212121212
Nepal,2002,486,58,56,2,96.55172414,0,58,0,161,20,34.48275862,8.379310345
Nepal,2003,22,15,15,0,100,0,15,0,34,6,40,1.466666667
Nepal,2004,630,62,59,3,95.16129032,0,62,0,397,28,45.16129032,10.16129032
Nepal,2005,211,70,70,0,100,0,70,0,249,34,48.57142857,3.014285714
Nepal,2006,133,83,82,1,98.79518072,0,83,0,93,28,33.73493976,1.602409639
Nepal,2007,44,90,86,4,95.55555556,0,90,0,59,35,38.88888889,0.488888889
Nepal,2008,50,120,116,4,96.66666667,0,120,0,326,30,25,0.416666667
Nepal,2009,20,39,39,0,100,0,39,0,135,13,33.33333333,0.512820513
Nepal,2010,10,38,37,1,97.36842105,0,38,0,42,10,26.31578947,0.263157895
Nepal,2011,16,46,41,5,89.13043478,0,46,0,80,12,26.08695652,0.347826087
Nepal,2012,9,46,21,25,45.65217391,0,46,0,29,3,6.52173913,0.195652174
Nepal,2013,3,104,55,49,52.88461538,0,104,0,88,3,2.884615385,0.028846154
Nepal,2014,0,7,4,3,57.14285714,0,7,0,7,0,0,0
Nepal,2015,0,48,36,12,75,0,48,0,11,0,0,0
Nepal,2016,5,43,35,8,81.39534884,0,43,0,15,4,9.302325581,0.11627907
Nepal,2017,4,247,111,136,44.93927126,0,247,0,94,4,1.619433198,0.016194332
Netherlands,1970,1,3,2,1,66.66666667,0,3,0,0,1,33.33333333,0.333333333
Netherlands,1971,0,1,1,0,100,0,1,0,0,0,0,0
Netherlands,1972,0,1,1,0,100,0,1,0,0,0,0,0
Netherlands,1973,1,1,1,0,100,0,1,0,1,1,100,1
Netherlands,1974,1,2,2,0,100,0,2,0,0,1,50,0.5
Netherlands,1975,4,4,4,0,100,0,4,0,2,2,50,1
Netherlands,1976,0,3,1,2,33.33333333,0,3,0,0,0,0,0
Netherlands,1977,9,6,5,1,83.33333333,0,6,0,1,2,33.33333333,1.5
Netherlands,1978,1,3,3,0,100,0,3,0,16,1,33.33333333,0.333333333
Netherlands,1979,3,3,3,0,100,0,3,0,0,2,66.66666667,1
Netherlands,1980,0,1,0,1,0,0,1,0,0,0,0,0
Netherlands,1981,0,1,1,0,100,0,1,0,0,0,0,0
Netherlands,1982,0,2,1,1,50,0,2,0,1,0,0,0
Netherlands,1983,0,2,2,0,100,0,2,0,0,0,0,0
Netherlands,1984,0,1,1,0,100,0,1,0,1,0,0,0
Netherlands,1985,0,4,2,2,50,0,4,0,0,0,0,0
Netherlands,1986,0,14,13,1,92.85714286,0,14,0,0,0,0,0
Netherlands,1987,0,1,0,1,0,0,1,0,0,0,0,0
Netherlands,1988,4,4,4,0,100,0,4,0,6,3,75,1
Netherlands,1989,0,5,4,1,80,0,5,0,5,0,0,0
Netherlands,1990,2,6,6,0,100,0,6,0,1,1,16.66666667,0.333333333
Netherlands,1991,0,8,8,0,100,0,8,0,0,0,0,0
Netherlands,1992,0,12,11,1,91.66666667,0,12,0,1,0,0,0
Netherlands,1994,0,3,2,1,66.66666667,0,3,0,1,0,0,0
Netherlands,1995,1,7,6,1,85.71428571,0,7,0,2,1,14.28571429,0.142857143
Netherlands,1996,0,6,6,0,100,0,6,0,0,0,0,0
Netherlands,1997,0,1,0,1,0,0,1,0,0,0,0,0
Netherlands,1999,0,1,1,0,100,0,1,0,0,0,0,0
Netherlands,2000,0,1,0,1,0,0,1,0,0,0,0,0
Netherlands,2001,0,1,1,0,100,0,1,0,3,0,0,0
Netherlands,2002,1,2,2,0,100,0,2,0,0,1,50,0.5
Netherlands,2003,0,3,1,2,33.33333333,0,3,0,0,0,0,0
Netherlands,2004,1,1,1,0,100,0,1,0,2,1,100,1
Netherlands,2008,0,1,1,0,100,0,1,0,0,0,0,0
Netherlands,2009,7,1,0,1,0,0,1,0,12,1,100,7
Netherlands,2010,0,1,0,1,0,0,1,0,0,0,0,0
Netherlands,2011,0,2,2,0,100,0,2,0,0,0,0,0
Netherlands,2014,0,1,0,1,0,0,1,0,0,0,0,0
Netherlands,2015,0,3,1,2,33.33333333,0,3,0,0,0,0,0
Netherlands,2016,1,6,6,0,100,0,6,0,3,1,16.66666667,0.166666667
Netherlands,2017,0,1,1,0,100,0,1,0,0,0,0,0
New Caledonia,1984,11,10,10,0,100,0,10,0,1,2,20,1.1
New Caledonia,1985,0,7,7,0,100,0,7,0,11,0,0,0
New Caledonia,1986,0,2,2,0,100,0,2,0,0,0,0,0
New Caledonia,1988,22,9,6,3,66.66666667,0,9,0,11,3,33.33333333,2.444444444
New Caledonia,1989,2,1,1,0,100,0,1,0,0,1,100,2
New Caledonia,1992,0,2,2,0,100,0,2,0,0,0,0,0
New Hebrides,1980,0,1,1,0,100,0,1,0,0,0,0,0
New Zealand,1973,0,1,1,0,100,0,1,0,0,0,0,0
New Zealand,1981,0,2,2,0,100,0,2,0,0,0,0,0
New Zealand,1984,1,1,1,0,100,0,1,0,0,1,100,1
New Zealand,1991,0,1,1,0,100,0,1,0,0,0,0,0
New Zealand,1994,0,1,1,0,100,0,1,0,0,0,0,0
New Zealand,1996,0,2,2,0,100,0,2,0,2,0,0,0
New Zealand,1997,0,1,1,0,100,0,1,0,0,0,0,0
New Zealand,2001,0,1,0,1,0,0,1,0,0,0,0,0
New Zealand,2003,0,3,0,3,0,0,3,0,0,0,0,0
New Zealand,2008,0,5,0,5,0,0,5,0,0,0,0,0
New Zealand,2014,0,1,1,0,100,0,1,0,0,0,0,0
New Zealand,2016,0,1,1,0,100,0,1,0,0,0,0,0
Nicaragua,1970,0,1,1,0,100,0,1,0,0,0,0,0
Nicaragua,1974,0,1,1,0,100,0,1,0,0,0,0,0
Nicaragua,1975,11,1,1,0,100,0,1,0,0,1,100,11
Nicaragua,1977,26,5,5,0,100,0,5,0,12,3,60,5.2
Nicaragua,1978,93,76,75,1,98.68421053,0,76,0,88,28,36.84210526,1.223684211
Nicaragua,1979,187,206,199,7,96.60194175,0,206,0,63,77,37.37864078,0.90776699
Nicaragua,1980,37,35,34,1,97.14285714,0,35,0,13,24,68.57142857,1.057142857
Nicaragua,1981,172,47,46,1,97.87234043,0,47,0,28,36,76.59574468,3.659574468
Nicaragua,1982,254,63,60,3,95.23809524,0,63,0,23,32,50.79365079,4.031746032
Nicaragua,1983,3277,299,296,3,98.99665552,0,299,0,316,147,49.1638796,10.95986622
Nicaragua,1984,3617,302,300,2,99.33774834,0,302,0,310,138,45.69536424,11.97682119
Nicaragua,1985,1575,258,256,2,99.2248062,0,258,0,231,86,33.33333333,6.104651163
Nicaragua,1986,395,171,171,0,100,0,171,0,103,59,34.50292398,2.30994152
Nicaragua,1987,549,223,220,3,98.65470852,0,223,0,294,82,36.77130045,2.461883408
Nicaragua,1988,208,62,62,0,100,0,62,0,78,37,59.67741935,3.35483871
Nicaragua,1989,48,21,21,0,100,0,21,0,24,14,66.66666667,2.285714286
Nicaragua,1990,23,15,14,1,93.33333333,0,15,0,8,4,26.66666667,1.533333333
Nicaragua,1991,54,80,79,1,98.75,0,80,0,45,22,27.5,0.675
Nicaragua,1992,22,30,30,0,100,0,30,0,13,8,26.66666667,0.733333333
Nicaragua,1994,12,19,16,3,84.21052632,0,19,0,7,6,31.57894737,0.631578947
Nicaragua,1995,6,18,17,1,94.44444444,0,18,0,26,3,16.66666667,0.333333333
Nicaragua,1996,18,26,24,2,92.30769231,0,26,0,15,7,26.92307692,0.692307692
Nicaragua,1997,7,7,7,0,100,0,7,0,5,2,28.57142857,1
Nicaragua,1999,0,1,1,0,100,0,1,0,0,0,0,0
Nicaragua,2000,2,1,1,0,100,0,1,0,1,1,100,2
Nicaragua,2014,5,2,2,0,100,0,2,0,28,2,100,2.5
Niger,1985,3,1,1,0,100,0,1,0,0,1,100,3
Niger,1989,171,1,1,0,100,0,1,0,0,1,100,171
Niger,1991,8,6,6,0,100,0,6,0,2,5,83.33333333,1.333333333
Niger,1992,34,16,15,1,93.75,0,16,0,13,10,62.5,2.125
Niger,1994,53,8,8,0,100,0,8,0,4,5,62.5,6.625
Niger,1995,22,2,1,1,50,0,2,0,0,2,100,11
Niger,1996,2,1,1,0,100,0,1,0,8,1,100,2
Niger,1997,32,3,3,0,100,0,3,0,5,2,66.66666667,10.66666667
Niger,1999,4,2,2,0,100,0,2,0,0,1,50,2
Niger,2007,66,7,7,0,100,0,7,0,52,4,57.14285714,9.428571429
Niger,2008,6,9,9,0,100,0,9,0,6,3,33.33333333,0.666666667
Niger,2009,18,4,4,0,100,0,4,0,3,4,100,4.5
Niger,2010,9,3,3,0,100,0,3,0,0,2,66.66666667,3
Niger,2011,4,2,2,0,100,0,2,0,6,2,100,2
Niger,2012,1,1,1,0,100,0,1,0,0,1,100,1
Niger,2013,26,4,4,0,100,2,2,50,33,3,75,6.5
Niger,2014,11,5,4,1,80,0,5,0,9,1,20,2.2
Niger,2015,666,41,37,4,90.24390244,6,35,14.63414634,116,35,85.36585366,16.24390244
Niger,2016,190,25,24,1,96,3,22,12,143,23,92,7.6
Niger,2017,148,13,13,0,100,1,12,7.692307692,72,12,92.30769231,11.38461538
Nigeria,1976,3,1,1,0,100,0,1,0,1,1,100,3
Nigeria,1980,0,1,1,0,100,0,1,0,0,0,0,0
Nigeria,1983,1,3,1,2,33.33333333,0,3,0,2,1,33.33333333,0.333333333
Nigeria,1988,4,2,2,0,100,0,2,0,0,2,100,2
Nigeria,1991,10,3,3,0,100,0,3,0,34,2,66.66666667,3.333333333
Nigeria,1992,135,11,9,2,81.81818182,0,11,0,130,6,54.54545455,12.27272727
Nigeria,1994,15,8,8,0,100,0,8,0,0,2,25,1.875
Nigeria,1995,1,1,1,0,100,0,1,0,0,1,100,1
Nigeria,1996,24,11,9,2,81.81818182,0,11,0,15,7,63.63636364,2.181818182
Nigeria,1997,107,20,18,2,90,0,20,0,51,11,55,5.35
Nigeria,1998,9,2,2,0,100,0,2,0,0,2,100,4.5
Nigeria,1999,134,18,18,0,100,0,18,0,209,5,27.77777778,7.444444444
Nigeria,2000,0,6,6,0,100,0,6,0,2,0,0,0
Nigeria,2001,3,5,5,0,100,0,5,0,3,2,40,0.6
Nigeria,2002,28,6,6,0,100,0,6,0,11,5,83.33333333,4.666666667
Nigeria,2003,28,9,9,0,100,0,9,0,44,4,44.44444444,3.111111111
Nigeria,2004,41,6,6,0,100,0,6,0,6,6,100,6.833333333
Nigeria,2005,19,9,9,0,100,0,9,0,36,4,44.44444444,2.111111111
Nigeria,2006,254,37,37,0,100,0,37,0,21,18,48.64864865,6.864864865
Nigeria,2007,82,61,57,4,93.44262295,0,61,0,40,21,34.42622951,1.344262295
Nigeria,2008,72,76,72,4,94.73684211,0,76,0,28,20,26.31578947,0.947368421
Nigeria,2009,316,42,40,2,95.23809524,0,42,0,16,9,21.42857143,7.523809524
Nigeria,2010,117,63,56,7,88.88888889,0,63,0,191,29,46.03174603,1.857142857
Nigeria,2011,447,175,159,16,90.85714286,4,171,2.285714286,619,118,67.42857143,2.554285714
Nigeria,2012,1508,616,558,58,90.58441558,36,580,5.844155844,913,389,63.14935065,2.448051948
Nigeria,2013,2014,346,319,27,92.19653179,4,342,1.156069364,528,245,70.80924855,5.820809249
Nigeria,2014,7781,714,669,45,93.69747899,40,674,5.602240896,2283,505,70.72829132,10.8977591
Nigeria,2015,5559,638,582,56,91.22257053,127,511,19.90595611,2863,485,76.01880878,8.713166144
Nigeria,2016,2165,533,495,38,92.87054409,54,479,10.13133208,1162,316,59.28705441,4.061913696
Nigeria,2017,1805,484,435,49,89.87603306,124,360,25.61983471,1031,376,77.68595041,3.729338843
North America,1970,34,472,389,83,82.41525424,0,472,0,160,28,5.93220339,0.072033898
North America,1971,20,247,214,33,86.63967611,0,247,0,55,16,6.477732794,0.08097166
North America,1972,11,73,52,21,71.23287671,0,73,0,42,8,10.95890411,0.150684932
North America,1973,46,64,56,8,87.5,0,64,0,33,26,40.625,0.71875
North America,1974,18,111,101,10,90.99099099,0,111,0,54,13,11.71171171,0.162162162
North America,1975,56,159,145,14,91.19496855,0,159,0,163,15,9.433962264,0.352201258
North America,1976,30,125,106,19,84.8,0,125,0,46,15,12,0.24
North America,1977,15,149,112,37,75.16778523,0,149,0,32,8,5.369127517,0.100671141
North America,1978,15,117,104,13,88.88888889,0,117,0,26,13,11.11111111,0.128205128
North America,1979,23,79,63,16,79.74683544,0,79,0,58,16,20.25316456,0.291139241
North America,1980,18,75,65,10,86.66666667,0,75,0,22,14,18.66666667,0.24
North America,1981,8,77,58,19,75.32467532,0,77,0,21,8,10.38961039,0.103896104
North America,1982,13,86,72,14,83.72093023,0,86,0,45,13,15.11627907,0.151162791
North America,1983,8,47,41,6,87.23404255,0,47,0,7,6,12.76595745,0.170212766
North America,1984,16,67,62,5,92.53731343,0,67,0,789,6,8.955223881,0.23880597
North America,1985,334,44,29,15,65.90909091,0,44,0,15,6,13.63636364,7.590909091
North America,1986,1,53,33,20,62.26415094,0,53,0,37,1,1.886792453,0.018867925
North America,1987,1,35,30,5,85.71428571,0,35,0,1,1,2.857142857,0.028571429
North America,1988,3,30,25,5,83.33333333,0,30,0,1,2,6.666666667,0.1
North America,1989,18,44,35,9,79.54545455,1,43,2.272727273,28,4,9.090909091,0.409090909
North America,1990,8,37,36,1,97.2972973,0,37,0,8,6,16.21621622,0.216216216
North America,1991,15,40,39,1,97.5,0,40,0,4,5,12.5,0.375
North America,1992,8,41,33,8,80.48780488,0,41,0,7,5,12.19512195,0.195121951
North America,1994,98,101,84,17,83.16831683,0,101,0,49,24,23.76237624,0.97029703
North America,1995,240,94,80,14,85.10638298,1,93,1.063829787,766,20,21.27659574,2.553191489
North America,1996,98,111,100,11,90.09009009,0,111,0,331,42,37.83783784,0.882882883
North America,1997,231,137,119,18,86.86131387,0,137,0,66,57,41.60583942,1.686131387
North America,1998,8,37,28,9,75.67567568,0,37,0,8,5,13.51351351,0.216216216
North America,1999,20,56,37,19,66.07142857,1,55,1.785714286,44,4,7.142857143,0.357142857
North America,2000,5,41,35,6,85.36585366,0,41,0,40,2,4.87804878,0.12195122
North America,2001,3021,48,39,9,81.25,4,44,8.333333333,16520,11,22.91666667,62.9375
North America,2002,4,33,21,12,63.63636364,1,32,3.03030303,11,2,6.060606061,0.121212121
North America,2003,2,34,28,6,82.35294118,0,34,0,1,1,2.941176471,0.058823529
North America,2004,0,12,9,3,75,0,12,0,3,0,0,0
North America,2005,2,22,17,5,77.27272727,0,22,0,0,1,4.545454545,0.090909091
North America,2006,8,15,13,2,86.66666667,0,15,0,48,5,33.33333333,0.533333333
North America,2007,25,18,15,3,83.33333333,0,18,0,6,8,44.44444444,1.388888889
North America,2008,23,31,29,2,93.5483871,1,30,3.225806452,126,7,22.58064516,0.741935484
North America,2009,20,16,14,2,87.5,1,15,6.25,44,6,37.5,1.25
North America,2010,4,24,18,6,75,2,22,8.333333333,17,3,12.5,0.166666667
North America,2011,0,12,8,4,66.66666667,0,12,0,3,0,0,0
North America,2012,24,39,36,3,92.30769231,0,39,0,15,8,20.51282051,0.615384615
North America,2013,70,32,22,10,68.75,0,32,0,546,11,34.375,2.1875
North America,2014,34,37,33,4,89.18918919,1,36,2.702702703,27,18,48.64864865,0.918918919
North America,2015,63,62,54,8,87.09677419,1,61,1.612903226,70,17,27.41935484,1.016129032
North America,2016,73,75,67,8,89.33333333,0,75,0,173,14,18.66666667,0.973333333
North America,2017,124,97,88,9,90.72164948,2,95,2.06185567,963,35,36.08247423,1.278350515
North Korea,1994,3,1,1,0,100,0,1,0,4,1,100,3
North Yemen,1974,0,1,1,0,100,0,1,0,1,0,0,0
North Yemen,1977,1,1,0,1,0,0,1,0,0,1,100,1
North Yemen,1978,1,2,1,1,50,0,2,0,0,1,50,0.5
North Yemen,1981,1,1,1,0,100,0,1,0,0,1,100,1
North Yemen,1988,0,1,1,0,100,0,1,0,0,0,0,0
Norway,1979,0,1,1,0,100,0,1,0,0,0,0,0
Norway,1981,0,1,1,0,100,0,1,0,0,0,0,0
Norway,1987,1,2,2,0,100,0,2,0,9,1,50,0.5
Norway,1991,0,2,2,0,100,0,2,0,0,0,0,0
Norway,1992,0,2,2,0,100,0,2,0,2,0,0,0
Norway,1994,0,2,2,0,100,0,2,0,0,0,0,0
Norway,1996,0,1,0,1,0,0,1,0,1,0,0,0
Norway,2001,1,1,1,0,100,0,1,0,0,1,100,1
Norway,2003,0,1,1,0,100,0,1,0,0,0,0,0
Norway,2006,0,1,1,0,100,0,1,0,0,0,0,0
Norway,2010,0,1,1,0,100,0,1,0,1,0,0,0
Norway,2011,77,3,2,1,66.66666667,0,3,0,75,2,66.66666667,25.66666667
Norway,2017,0,1,0,1,0,0,1,0,0,0,0,0
Pakistan,1970,4,1,1,0,100,0,1,0,20,1,100,4
Pakistan,1974,0,2,2,0,100,0,2,0,2,0,0,0
Pakistan,1975,1,2,2,0,100,0,2,0,0,1,50,0.5
Pakistan,1976,1,3,3,0,100,0,3,0,3,1,33.33333333,0.333333333
Pakistan,1978,5,2,2,0,100,0,2,0,2,2,100,2.5
Pakistan,1979,6,7,6,1,85.71428571,0,7,0,42,1,14.28571429,0.857142857
Pakistan,1980,17,1,1,0,100,0,1,0,18,1,100,17
Pakistan,1981,4,4,3,1,75,0,4,0,4,3,75,1
Pakistan,1982,3,4,3,1,75,0,4,0,9,1,25,0.75
Pakistan,1983,10,9,9,0,100,0,9,0,26,2,22.22222222,1.111111111
Pakistan,1984,12,3,3,0,100,0,3,0,49,2,66.66666667,4
Pakistan,1985,0,2,2,0,100,0,2,0,1,0,0,0
Pakistan,1986,60,24,22,2,91.66666667,0,24,0,351,14,58.33333333,2.5
Pakistan,1987,183,60,58,2,96.66666667,0,60,0,1095,30,50,3.05
Pakistan,1988,136,44,41,3,93.18181818,0,44,0,266,27,61.36363636,3.090909091
Pakistan,1989,56,45,43,2,95.55555556,0,45,0,248,23,51.11111111,1.244444444
Pakistan,1990,188,87,82,5,94.25287356,0,87,0,486,43,49.42528736,2.16091954
Pakistan,1991,231,150,140,10,93.33333333,0,150,0,599,65,43.33333333,1.54
Pakistan,1992,152,85,82,3,96.47058824,0,85,0,393,45,52.94117647,1.788235294
Pakistan,1994,354,154,147,7,95.45454545,0,154,0,434,108,70.12987013,2.298701299
Pakistan,1995,712,666,613,53,92.04204204,2,664,0.3003003,615,329,49.3993994,1.069069069
Pakistan,1996,423,180,174,6,96.66666667,0,180,0,755,124,68.88888889,2.35
Pakistan,1997,443,206,202,4,98.05825243,0,206,0,525,187,90.77669903,2.150485437
Pakistan,1998,151,37,36,1,97.2972973,1,36,2.702702703,349,28,75.67567568,4.081081081
Pakistan,1999,127,39,36,3,92.30769231,0,39,0,246,28,71.79487179,3.256410256
Pakistan,2000,118,49,48,1,97.95918367,0,49,0,448,28,57.14285714,2.408163265
Pakistan,2001,109,53,51,2,96.22641509,0,53,0,265,36,67.9245283,2.056603774
Pakistan,2002,105,46,40,6,86.95652174,2,44,4.347826087,331,27,58.69565217,2.282608696
Pakistan,2003,119,29,26,3,89.65517241,3,26,10.34482759,181,17,58.62068966,4.103448276
Pakistan,2004,304,67,65,2,97.01492537,5,62,7.462686567,671,47,70.14925373,4.537313433
Pakistan,2005,152,77,75,2,97.4025974,5,72,6.493506494,284,33,42.85714286,1.974025974
Pakistan,2006,315,164,159,5,96.95121951,7,157,4.268292683,669,72,43.90243902,1.920731707
Pakistan,2007,1406,260,255,5,98.07692308,58,202,22.30769231,2343,156,60,5.407692308
Pakistan,2008,1184,568,551,17,97.00704225,37,531,6.514084507,1901,268,47.18309859,2.084507042
Pakistan,2009,1487,667,653,14,97.90104948,47,620,7.046476762,3541,288,43.17841079,2.229385307
Pakistan,2010,1699,713,674,39,94.53015428,34,679,4.76858345,2961,333,46.70406732,2.382889201
Pakistan,2011,1676,1012,964,48,95.256917,43,969,4.249011858,2649,505,49.90118577,1.656126482
Pakistan,2012,2784,1654,1471,183,88.93591294,52,1602,3.143893591,4265,740,44.74002418,1.683192261
Pakistan,2013,2875,2215,1816,399,81.98645598,80,2135,3.611738149,5769,837,37.78781038,1.297968397
Pakistan,2014,2413,2151,1844,307,85.72756857,43,2108,1.9990702,3388,871,40.49279405,1.121803812
Pakistan,2015,1608,1243,972,271,78.19790829,30,1213,2.413515688,1849,550,44.24778761,1.293644409
Pakistan,2016,1113,864,668,196,77.31481481,31,833,3.587962963,1894,413,47.80092593,1.288194444
Pakistan,2017,1076,719,555,164,77.19054242,31,688,4.311543811,2091,306,42.55910987,1.496522949
Palestine,1972,1,1,1,0,100,0,1,0,3,1,100,1
Palestine,1976,2,1,1,0,100,0,1,0,0,1,100,2
Palestine,1978,6,4,3,1,75,0,4,0,37,2,50,1.5
Palestine,1979,2,22,19,3,86.36363636,0,22,0,25,2,9.090909091,0.090909091
Palestine,1980,31,56,38,18,67.85714286,0,56,0,70,17,30.35714286,0.553571429
Palestine,1981,6,17,13,4,76.47058824,0,17,0,57,5,29.41176471,0.352941176
Palestine,1982,7,39,32,7,82.05128205,0,39,0,36,6,15.38461538,0.179487179
Palestine,1983,9,34,29,5,85.29411765,0,34,0,22,6,17.64705882,0.264705882
Palestine,1984,5,26,24,2,92.30769231,0,26,0,48,4,15.38461538,0.192307692
Palestine,1985,0,1,1,0,100,0,1,0,2,0,0,0
Palestine,1986,4,13,12,1,92.30769231,0,13,0,24,4,30.76923077,0.307692308
Palestine,1987,3,11,8,3,72.72727273,0,11,0,7,3,27.27272727,0.272727273
Palestine,1988,10,18,15,3,83.33333333,0,18,0,13,6,33.33333333,0.555555556
Palestine,1989,72,100,90,10,90,0,100,0,30,69,69,0.72
Palestine,1990,62,88,79,9,89.77272727,0,88,0,28,59,67.04545455,0.704545455
Palestine,1991,43,83,68,15,81.92771084,0,83,0,50,33,39.75903614,0.518072289
Palestine,1992,93,119,100,19,84.03361345,0,119,0,183,70,58.82352941,0.781512605
Palestine,1994,129,165,136,29,82.42424242,2,163,1.212121212,387,66,40,0.781818182
Palestine,1995,43,67,52,15,77.6119403,3,64,4.47761194,129,24,35.82089552,0.641791045
Palestine,1996,17,30,25,5,83.33333333,0,30,0,31,11,36.66666667,0.566666667
Palestine,1997,9,22,20,2,90.90909091,2,20,9.090909091,29,8,36.36363636,0.409090909
Palestine,1998,12,12,11,1,91.66666667,2,10,16.66666667,26,7,58.33333333,1
Palestine,1999,1,11,8,3,72.72727273,0,11,0,12,1,9.090909091,0.090909091
Palestine,2000,21,28,25,3,89.28571429,3,25,10.71428571,48,14,50,0.75
Palestine,2001,105,123,108,15,87.80487805,4,119,3.25203252,182,57,46.34146341,0.853658537
Palestine,2002,177,86,74,12,86.04651163,15,71,17.44186047,262,66,76.74418605,2.058139535
Palestine,2003,60,45,38,7,84.44444444,13,32,28.88888889,95,28,62.22222222,1.333333333
Palestine,2004,31,34,29,5,85.29411765,8,26,23.52941176,60,15,44.11764706,0.911764706
Palestine,2005,20,38,31,7,81.57894737,2,36,5.263157895,48,13,34.21052632,0.526315789
Palestine,2006,20,35,33,2,94.28571429,2,33,5.714285714,19,11,31.42857143,0.571428571
Palestine,2007,112,88,79,9,89.77272727,0,88,0,351,33,37.5,1.272727273
Palestine,2008,17,63,58,5,92.06349206,0,63,0,91,8,12.6984127,0.26984127
Palestine,2009,7,10,8,2,80,0,10,0,3,5,50,0.7
Palestine,2010,0,11,8,3,72.72727273,0,11,0,16,0,0,0
Palestine,2011,15,20,16,4,80,0,20,0,11,9,45,0.75
Palestine,2012,12,23,20,3,86.95652174,0,23,0,20,6,26.08695652,0.52173913
Palestine,2013,12,64,38,26,59.375,0,64,0,27,11,17.1875,0.1875
Palestine,2014,67,133,106,27,79.69924812,5,128,3.759398496,94,24,18.04511278,0.503759398
Palestine,2015,117,246,174,72,70.73170732,1,245,0.406504065,239,94,38.21138211,0.475609756
Palestine,2016,90,157,86,71,54.77707006,1,156,0.636942675,124,69,43.94904459,0.573248408
Palestine,2017,50,83,50,33,60.24096386,3,80,3.614457831,75,31,37.34939759,0.602409639
Panama,1972,0,1,1,0,100,0,1,0,0,0,0,0
Panama,1976,0,2,2,0,100,0,2,0,0,0,0,0
Panama,1979,1,4,4,0,100,0,4,0,1,1,25,0.25
Panama,1980,0,4,4,0,100,0,4,0,0,0,0,0
Panama,1981,1,4,4,0,100,0,4,0,2,1,25,0.25
Panama,1983,0,9,9,0,100,0,9,0,1,0,0,0
Panama,1984,0,2,2,0,100,0,2,0,0,0,0,0
Panama,1986,0,5,4,1,80,0,5,0,0,0,0,0
Panama,1987,1,4,3,1,75,0,4,0,0,1,25,0.25
Panama,1988,0,1,0,1,0,0,1,0,1,0,0,0
Panama,1989,0,2,1,1,50,0,2,0,0,0,0,0
Panama,1990,2,15,13,2,86.66666667,0,15,0,54,2,13.33333333,0.133333333
Panama,1991,2,16,12,4,75,0,16,0,0,2,12.5,0.125
Panama,1992,3,37,32,5,86.48648649,0,37,0,20,2,5.405405405,0.081081081
Panama,1994,21,3,3,0,100,1,2,33.33333333,0,1,33.33333333,7
Panama,1995,3,6,5,1,83.33333333,0,6,0,0,3,50,0.5
Panama,1996,0,2,2,0,100,0,2,0,0,0,0,0
Panama,1997,3,6,6,0,100,0,6,0,4,3,50,0.5
Panama,1999,0,1,1,0,100,0,1,0,0,0,0,0
Panama,2000,0,1,0,1,0,0,1,0,0,0,0,0
Panama,2009,1,1,1,0,100,0,1,0,0,1,100,1
Panama,2016,0,1,1,0,100,0,1,0,0,0,0,0
Papua New Guinea,1989,13,24,20,4,83.33333333,0,24,0,25,7,29.16666667,0.541666667
Papua New Guinea,1990,12,18,17,1,94.44444444,0,18,0,12,5,27.77777778,0.666666667
Papua New Guinea,1991,3,2,1,1,50,0,2,0,0,2,100,1.5
Papua New Guinea,1992,7,10,9,1,90,0,10,0,10,2,20,0.7
Papua New Guinea,1994,17,3,1,2,33.33333333,0,3,0,26,1,33.33333333,5.666666667
Papua New Guinea,1995,6,10,9,1,90,0,10,0,4,3,30,0.6
Papua New Guinea,1996,21,10,10,0,100,0,10,0,11,4,40,2.1
Papua New Guinea,1997,0,2,2,0,100,0,2,0,0,0,0,0
Papua New Guinea,2002,0,1,1,0,100,0,1,0,0,0,0,0
Papua New Guinea,2007,0,1,1,0,100,0,1,0,0,0,0,0
Papua New Guinea,2017,0,8,6,2,75,0,8,0,3,0,0,0
Paraguay,1970,1,1,1,0,100,0,1,0,1,1,100,1
Paraguay,1976,1,1,1,0,100,0,1,0,0,1,100,1
Paraguay,1980,3,2,1,1,50,0,2,0,0,1,50,1.5
Paraguay,1984,1,2,1,1,50,0,2,0,1,1,50,0.5
Paraguay,1985,0,1,1,0,100,0,1,0,0,0,0,0
Paraguay,1987,0,1,1,0,100,0,1,0,0,0,0,0
Paraguay,1992,0,4,3,1,75,0,4,0,0,0,0,0
Paraguay,1994,1,2,1,1,50,0,2,0,2,1,50,0.5
Paraguay,1995,0,12,12,0,100,0,12,0,16,0,0,0
Paraguay,1997,1,6,6,0,100,0,6,0,12,1,16.66666667,0.166666667
Paraguay,1999,2,1,1,0,100,0,1,0,1,1,100,2
Paraguay,2000,0,2,1,1,50,0,2,0,3,0,0,0
Paraguay,2010,2,2,2,0,100,0,2,0,7,1,50,1
Paraguay,2011,0,4,3,1,75,0,4,0,4,0,0,0
Paraguay,2012,1,4,4,0,100,0,4,0,2,1,25,0.25
Paraguay,2013,12,10,9,1,90,0,10,0,15,8,80,1.2
Paraguay,2014,6,15,15,0,100,0,15,0,2,3,20,0.4
Paraguay,2015,14,19,14,5,73.68421053,0,19,0,0,7,36.84210526,0.736842105
Paraguay,2016,10,15,14,1,93.33333333,0,15,0,2,3,20,0.666666667
Paraguay,2017,4,10,10,0,100,0,10,0,1,3,30,0.4
Peru,1973,0,3,3,0,100,0,3,0,0,0,0,0
Peru,1974,0,3,3,0,100,0,3,0,15,0,0,0
Peru,1975,0,2,2,0,100,0,2,0,0,0,0,0
Peru,1977,0,4,4,0,100,0,4,0,0,0,0,0
Peru,1978,0,4,4,0,100,0,4,0,0,0,0,0
Peru,1979,5,3,3,0,100,0,3,0,1,1,33.33333333,1.666666667
Peru,1980,2,64,54,10,84.375,0,64,0,5,2,3.125,0.03125
Peru,1981,10,149,134,15,89.93288591,0,149,0,19,6,4.026845638,0.067114094
Peru,1982,243,350,325,25,92.85714286,0,350,0,71,77,22,0.694285714
Peru,1983,1818,536,497,39,92.7238806,0,536,0,263,248,46.26865672,3.391791045
Peru,1984,2467,592,567,25,95.77702703,0,592,0,519,255,43.07432432,4.16722973
Peru,1985,729,352,314,38,89.20454545,0,352,0,127,98,27.84090909,2.071022727
Peru,1986,513,568,534,34,94.01408451,0,568,0,271,142,25,0.903169014
Peru,1987,773,627,595,32,94.89633174,0,627,0,357,172,27.43221691,1.232854864
Peru,1988,855,355,344,11,96.90140845,0,355,0,246,170,47.88732394,2.408450704
Peru,1989,1502,630,611,19,96.98412698,0,630,0,340,287,45.55555556,2.384126984
Peru,1990,1146,495,478,17,96.56565657,0,495,0,237,220,44.44444444,2.315151515
Peru,1991,1412,658,631,27,95.89665653,0,658,0,420,232,35.25835866,2.145896657
Peru,1992,818,383,357,26,93.21148825,0,383,0,762,183,47.78067885,2.135770235
Peru,1994,81,91,85,6,93.40659341,0,91,0,64,24,26.37362637,0.89010989
Peru,1995,103,44,40,4,90.90909091,0,44,0,48,16,36.36363636,2.340909091
Peru,1996,74,42,40,2,95.23809524,0,42,0,74,21,50,1.761904762
Peru,1997,47,58,55,3,94.82758621,0,58,0,57,16,27.5862069,0.810344828
Peru,1998,7,5,5,0,100,0,5,0,12,4,80,1.4
Peru,1999,28,5,5,0,100,0,5,0,3,4,80,5.6
Peru,2000,4,3,3,0,100,0,3,0,6,2,66.66666667,1.333333333
Peru,2001,16,3,3,0,100,0,3,0,9,1,33.33333333,5.333333333
Peru,2002,9,2,2,0,100,0,2,0,32,1,50,4.5
Peru,2003,7,1,1,0,100,0,1,0,10,1,100,7
Peru,2004,6,3,3,0,100,0,3,0,5,3,100,2
Peru,2005,7,2,2,0,100,0,2,0,2,2,100,3.5
Peru,2006,7,1,1,0,100,0,1,0,0,1,100,7
Peru,2007,18,4,4,0,100,0,4,0,52,4,100,4.5
Peru,2008,0,1,1,0,100,0,1,0,0,0,0,0
Peru,2009,19,4,4,0,100,0,4,0,9,3,75,4.75
Peru,2012,10,6,6,0,100,0,6,0,8,2,33.33333333,1.666666667
Peru,2013,6,10,9,1,90,0,10,0,4,6,60,0.6
Peru,2014,4,12,10,2,83.33333333,0,12,0,12,3,25,0.333333333
Peru,2015,6,10,7,3,70,0,10,0,7,6,60,0.6
Peru,2016,11,3,3,0,100,0,3,0,7,2,66.66666667,3.666666667
Peru,2017,8,8,6,2,75,0,8,0,4,4,50,1
Philippines,1970,41,10,9,1,90,0,10,0,13,5,50,4.1
Philippines,1971,0,4,4,0,100,0,4,0,0,0,0,0
Philippines,1972,2,7,6,1,85.71428571,0,7,0,1,2,28.57142857,0.285714286
Philippines,1974,3,1,1,0,100,0,1,0,0,1,100,3
Philippines,1975,1,4,4,0,100,0,4,0,45,1,25,0.25
Philippines,1976,47,10,10,0,100,0,10,0,73,5,50,4.7
Philippines,1977,0,2,2,0,100,0,2,0,0,0,0,0
Philippines,1978,128,36,35,1,97.22222222,0,36,0,193,20,55.55555556,3.555555556
Philippines,1979,107,50,47,3,94,0,50,0,76,31,62,2.14
Philippines,1980,163,60,53,7,88.33333333,0,60,0,540,23,38.33333333,2.716666667
Philippines,1981,176,31,31,0,100,0,31,0,362,20,64.51612903,5.677419355
Philippines,1982,139,38,35,3,92.10526316,0,38,0,250,26,68.42105263,3.657894737
Philippines,1983,101,16,16,0,100,0,16,0,30,11,68.75,6.3125
Philippines,1984,262,43,41,2,95.34883721,0,43,0,108,40,93.02325581,6.093023256
Philippines,1985,452,124,121,3,97.58064516,0,124,0,377,68,54.83870968,3.64516129
Philippines,1986,322,80,74,6,92.5,0,80,0,355,55,68.75,4.025
Philippines,1987,404,160,147,13,91.875,0,160,0,485,87,54.375,2.525
Philippines,1988,550,210,195,15,92.85714286,0,210,0,256,154,73.33333333,2.619047619
Philippines,1989,393,156,149,7,95.51282051,0,156,0,323,101,64.74358974,2.519230769
Philippines,1990,457,320,290,30,90.625,0,320,0,340,131,40.9375,1.428125
Philippines,1991,432,162,149,13,91.97530864,0,162,0,247,81,50,2.666666667
Philippines,1992,395,162,156,6,96.2962963,0,162,0,465,96,59.25925926,2.438271605
Philippines,1994,126,72,68,4,94.44444444,0,72,0,198,33,45.83333333,1.75
Philippines,1995,201,63,59,4,93.65079365,0,63,0,102,32,50.79365079,3.19047619
Philippines,1996,95,61,56,5,91.80327869,0,61,0,143,30,49.18032787,1.557377049
Philippines,1997,98,57,54,3,94.73684211,0,57,0,273,33,57.89473684,1.719298246
Philippines,1998,6,18,17,1,94.44444444,0,18,0,85,4,22.22222222,0.333333333
Philippines,1999,45,31,30,1,96.77419355,0,31,0,190,10,32.25806452,1.451612903
Philippines,2000,290,132,123,9,93.18181818,3,129,2.272727273,643,64,48.48484848,2.196969697
Philippines,2001,154,50,44,6,88,0,50,0,274,26,52,3.08
Philippines,2002,125,48,46,2,95.83333333,0,48,0,342,30,62.5,2.604166667
Philippines,2003,288,107,103,4,96.26168224,2,105,1.869158879,531,56,52.3364486,2.691588785
Philippines,2004,206,32,30,2,93.75,0,32,0,160,20,62.5,6.4375
Philippines,2005,49,25,23,2,92,0,25,0,149,15,60,1.96
Philippines,2006,60,58,55,3,94.82758621,0,58,0,163,26,44.82758621,1.034482759
Philippines,2007,115,65,61,4,93.84615385,0,65,0,404,37,56.92307692,1.769230769
Philippines,2008,220,276,238,38,86.23188406,1,275,0.362318841,388,97,35.14492754,0.797101449
Philippines,2009,151,229,206,23,89.95633188,0,229,0,354,85,37.11790393,0.659388646
Philippines,2010,155,205,186,19,90.73170732,1,204,0.487804878,231,93,45.36585366,0.756097561
Philippines,2011,127,151,132,19,87.41721854,0,151,0,225,66,43.70860927,0.841059603
Philippines,2012,211,249,220,29,88.35341365,0,249,0,440,105,42.1686747,0.847389558
Philippines,2013,432,651,541,110,83.10291859,1,650,0.153609831,666,252,38.70967742,0.66359447
Philippines,2014,472,597,497,100,83.24958124,0,597,0,723,228,38.19095477,0.790619765
Philippines,2015,447,721,561,160,77.80859917,0,721,0,752,296,41.05409154,0.619972261
Philippines,2016,415,632,489,143,77.37341772,0,632,0,718,269,42.56329114,0.65664557
Philippines,2017,496,692,561,131,81.06936416,1,691,0.144508671,674,289,41.76300578,0.716763006
Poland,1971,0,1,1,0,100,0,1,0,0,0,0,0
Poland,1979,0,1,1,0,100,0,1,0,5,0,0,0
Poland,1981,0,1,0,1,0,0,1,0,1,0,0,0
Poland,1990,1,7,7,0,100,0,7,0,1,1,14.28571429,0.142857143
Poland,1992,4,5,5,0,100,0,5,0,5,3,60,0.8
Poland,1994,0,4,1,3,25,0,4,0,0,0,0,0
Poland,1995,0,4,4,0,100,0,4,0,1,0,0,0
Poland,1996,1,6,6,0,100,0,6,0,7,1,16.66666667,0.166666667
Poland,1997,2,3,3,0,100,0,3,0,5,2,66.66666667,0.666666667
Poland,1998,0,2,2,0,100,0,2,0,0,0,0,0
Poland,2001,0,1,1,0,100,0,1,0,4,0,0,0
Poland,2010,1,1,1,0,100,0,1,0,1,1,100,1
Poland,2016,0,2,1,1,50,0,2,0,1,0,0,0
Poland,2017,0,1,1,0,100,0,1,0,0,0,0,0
Portugal,1972,0,1,0,1,0,0,1,0,0,0,0,0
Portugal,1973,0,1,0,1,0,0,1,0,1,0,0,0
Portugal,1975,0,4,4,0,100,0,4,0,0,0,0,0
Portugal,1976,3,15,15,0,100,0,15,0,11,2,13.33333333,0.2
Portugal,1977,0,15,15,0,100,0,15,0,11,0,0,0
Portugal,1978,0,4,4,0,100,0,4,0,11,0,0,0
Portugal,1979,3,15,14,1,93.33333333,0,15,0,6,3,20,0.2
Portugal,1980,3,8,7,1,87.5,0,8,0,9,3,37.5,0.375
Portugal,1981,2,10,7,3,70,0,10,0,3,1,10,0.2
Portugal,1982,3,3,3,0,100,0,3,0,1,2,66.66666667,1
Portugal,1983,8,9,9,0,100,0,9,0,4,2,22.22222222,0.888888889
Portugal,1984,3,14,11,3,78.57142857,0,14,0,13,2,14.28571429,0.214285714
Portugal,1985,1,20,20,0,100,0,20,0,8,1,5,0.05
Portugal,1986,1,11,11,0,100,0,11,0,1,1,9.090909091,0.090909091
Portugal,1988,2,2,2,0,100,0,2,0,0,2,100,1
Portugal,1989,1,1,1,0,100,0,1,0,0,1,100,1
Portugal,1992,0,1,0,1,0,0,1,0,1,0,0,0
Portugal,1994,2,1,1,0,100,0,1,0,0,1,100,2
Portugal,1995,0,3,3,0,100,0,3,0,15,0,0,0
Portugal,2011,0,2,2,0,100,0,2,0,0,0,0,0
Qatar,1982,1,1,1,0,100,0,1,0,0,1,100,1
Qatar,1989,3,1,1,0,100,0,1,0,0,1,100,3
Qatar,1996,0,1,0,1,0,0,1,0,0,0,0,0
Qatar,2000,0,1,1,0,100,0,1,0,0,0,0,0
Qatar,2001,1,1,1,0,100,0,1,0,0,1,100,1
Qatar,2005,2,1,1,0,100,1,0,100,12,1,100,2
Qatar,2015,0,1,1,0,100,0,1,0,1,0,0,0
Rhodesia,1978,73,19,19,0,100,0,19,0,7,9,47.36842105,3.842105263
Rhodesia,1979,120,51,49,2,96.07843137,0,51,0,52,25,49.01960784,2.352941176
Rhodesia,1980,24,13,12,1,92.30769231,0,13,0,99,6,46.15384615,1.846153846
Romania,1984,1,1,1,0,100,0,1,0,0,1,100,1
Romania,1985,2,1,1,0,100,0,1,0,0,1,100,2
Romania,1991,1,1,0,1,0,0,1,0,3,1,100,1
Romania,1992,0,1,0,1,0,0,1,0,0,0,0,0
Romania,1995,0,1,1,0,100,0,1,0,5,0,0,0
Romania,2008,0,1,1,0,100,0,1,0,1,0,0,0
Russia,1992,34,21,17,4,80.95238095,0,21,0,38,10,47.61904762,1.619047619
Russia,1994,34,47,32,15,68.08510638,0,47,0,33,17,36.17021277,0.723404255
Russia,1995,145,37,28,9,75.67567568,0,37,0,34,17,45.94594595,3.918918919
Russia,1996,135,66,53,13,80.3030303,0,66,0,124,30,45.45454545,2.045454545
Russia,1997,61,77,69,8,89.61038961,0,77,0,108,27,35.06493506,0.792207792
Russia,1998,49,26,24,2,92.30769231,0,26,0,118,14,53.84615385,1.884615385
Russia,1999,395,54,40,14,74.07407407,0,54,0,678,20,37.03703704,7.314814815
Russia,2000,362,138,112,26,81.15942029,10,128,7.246376812,568,79,57.24637681,2.623188406
Russia,2001,228,135,114,21,84.44444444,2,133,1.481481481,454,73,54.07407407,1.688888889
Russia,2002,512,89,81,8,91.01123596,3,86,3.370786517,426,54,60.6741573,5.752808989
Russia,2003,328,76,60,16,78.94736842,10,66,13.15789474,812,44,57.89473684,4.315789474
Russia,2004,607,44,35,9,79.54545455,8,36,18.18181818,1171,25,56.81818182,13.79545455
Russia,2005,157,64,56,8,87.5,0,64,0,350,34,53.125,2.453125
Russia,2006,57,56,51,5,91.07142857,2,54,3.571428571,59,23,41.07142857,1.017857143
Russia,2007,55,51,49,2,96.07843137,2,49,3.921568627,140,26,50.98039216,1.078431373
Russia,2008,95,170,135,35,79.41176471,1,169,0.588235294,233,52,30.58823529,0.558823529
Russia,2009,141,152,125,27,82.23684211,5,147,3.289473684,218,66,43.42105263,0.927631579
Russia,2010,231,251,213,38,84.86055777,11,240,4.38247012,609,96,38.24701195,0.920318725
Russia,2011,160,188,160,28,85.10638298,6,182,3.191489362,433,76,40.42553191,0.85106383
Russia,2012,161,151,117,34,77.48344371,8,143,5.298013245,260,67,44.37086093,1.066225166
Russia,2013,148,144,113,31,78.47222222,9,135,6.25,288,68,47.22222222,1.027777778
Russia,2014,67,48,43,5,89.58333333,1,47,2.083333333,88,22,45.83333333,1.395833333
Russia,2015,21,21,16,5,76.19047619,0,21,0,24,12,57.14285714,1
Russia,2016,64,55,39,16,70.90909091,4,51,7.272727273,61,26,47.27272727,1.163636364
Russia,2017,61,33,28,5,84.84848485,4,29,12.12121212,114,18,54.54545455,1.848484848
Rwanda,1991,0,3,1,2,33.33333333,0,3,0,0,0,0,0
Rwanda,1992,141,18,18,0,100,0,18,0,182,14,77.77777778,7.833333333
Rwanda,1994,1571,33,33,0,100,0,33,0,9,24,72.72727273,47.60606061
Rwanda,1995,201,17,17,0,100,0,17,0,86,14,82.35294118,11.82352941
Rwanda,1996,129,15,15,0,100,0,15,0,3,14,93.33333333,8.6
Rwanda,1997,1027,33,32,1,96.96969697,0,33,0,274,29,87.87878788,31.12121212
Rwanda,1998,100,9,9,0,100,0,9,0,51,6,66.66666667,11.11111111
Rwanda,2000,4,1,1,0,100,0,1,0,0,1,100,4
Rwanda,2001,2,2,1,1,50,0,2,0,1,2,100,1
Rwanda,2005,30,1,1,0,100,0,1,0,0,1,100,30
Rwanda,2008,0,1,1,0,100,0,1,0,4,0,0,0
Rwanda,2009,4,1,1,0,100,0,1,0,52,1,100,4
Rwanda,2010,6,8,8,0,100,0,8,0,85,5,62.5,0.75
Rwanda,2011,2,2,2,0,100,0,2,0,49,1,50,1
Rwanda,2012,10,6,6,0,100,0,6,0,40,3,50,1.666666667
Rwanda,2013,6,4,4,0,100,0,4,0,62,4,100,1.5
Rwanda,2014,1,2,2,0,100,0,2,0,16,1,50,0.5
Rwanda,2016,0,1,0,1,0,0,1,0,0,0,0,0
Rwanda,2017,2,2,2,0,100,0,2,0,8,2,100,1
Saint Kitts and Nevis,1995,0,2,2,0,100,0,2,0,9,0,0,0
Saint Lucia,2000,2,1,1,0,100,0,1,0,12,1,100,2
Saudi Arabia,1977,0,1,1,0,100,0,1,0,0,0,0,0
Saudi Arabia,1979,5,1,1,0,100,0,1,0,10,1,100,5
Saudi Arabia,1984,0,2,2,0,100,0,2,0,1,0,0,0
Saudi Arabia,1985,1,2,2,0,100,0,2,0,3,1,50,0.5
Saudi Arabia,1986,62,1,1,0,100,0,1,0,32,1,100,62
Saudi Arabia,1988,0,1,1,0,100,0,1,0,0,0,0,0
Saudi Arabia,1989,1,3,3,0,100,0,3,0,16,1,33.33333333,0.333333333
Saudi Arabia,1991,0,2,2,0,100,0,2,0,6,0,0,0
Saudi Arabia,1994,0,2,2,0,100,0,2,0,0,0,0,0
Saudi Arabia,1995,14,3,2,1,66.66666667,0,3,0,161,2,66.66666667,4.666666667
Saudi Arabia,1996,19,1,1,0,100,0,1,0,386,1,100,19
Saudi Arabia,2000,1,5,5,0,100,0,5,0,5,1,20,0.2
Saudi Arabia,2001,2,3,3,0,100,0,3,0,7,1,33.33333333,0.666666667
Saudi Arabia,2002,1,2,2,0,100,0,2,0,0,1,50,0.5
Saudi Arabia,2003,55,8,7,1,87.5,4,4,50,128,5,62.5,6.875
Saudi Arabia,2004,64,17,15,2,88.23529412,2,15,11.76470588,293,13,76.47058824,3.764705882
Saudi Arabia,2005,1,1,1,0,100,0,1,0,0,1,100,1
Saudi Arabia,2006,4,3,2,1,66.66666667,1,2,33.33333333,8,1,33.33333333,1.333333333
Saudi Arabia,2007,3,1,1,0,100,0,1,0,1,1,100,3
Saudi Arabia,2009,5,3,2,1,66.66666667,1,2,33.33333333,13,3,100,1.666666667
Saudi Arabia,2011,3,2,2,0,100,0,2,0,15,1,50,1.5
Saudi Arabia,2012,4,6,6,0,100,0,6,0,10,3,50,0.666666667
Saudi Arabia,2013,1,6,6,0,100,0,6,0,2,1,16.66666667,0.166666667
Saudi Arabia,2014,20,14,13,1,92.85714286,1,13,7.142857143,23,6,42.85714286,1.428571429
Saudi Arabia,2015,213,103,97,6,94.17475728,8,95,7.766990291,281,68,66.01941748,2.067961165
Saudi Arabia,2016,162,124,98,26,79.03225806,7,117,5.64516129,196,57,45.96774194,1.306451613
Saudi Arabia,2017,31,54,41,13,75.92592593,1,53,1.851851852,69,24,44.44444444,0.574074074
Senegal,1980,0,1,1,0,100,0,1,0,0,0,0,0
Senegal,1988,2,3,3,0,100,0,3,0,4,1,33.33333333,0.666666667
Senegal,1990,20,11,11,0,100,0,11,0,65,7,63.63636364,1.818181818
Senegal,1991,5,4,4,0,100,0,4,0,0,4,100,1.25
Senegal,1992,64,15,14,1,93.33333333,0,15,0,22,12,80,4.266666667
Senegal,1994,5,2,2,0,100,0,2,0,0,1,50,2.5
Senegal,1995,18,8,8,0,100,0,8,0,23,7,87.5,2.25
Senegal,1997,92,26,26,0,100,0,26,0,48,20,76.92307692,3.538461538
Senegal,1998,4,1,1,0,100,0,1,0,4,1,100,4
Senegal,1999,1,1,1,0,100,0,1,0,12,1,100,1
Senegal,2000,4,4,4,0,100,0,4,0,12,2,50,1
Senegal,2001,28,8,7,1,87.5,0,8,0,19,5,62.5,3.5
Senegal,2002,8,3,3,0,100,0,3,0,19,3,100,2.666666667
Senegal,2005,0,1,1,0,100,0,1,0,0,0,0,0
Senegal,2007,1,1,1,0,100,0,1,0,13,1,100,1
Senegal,2008,10,2,2,0,100,0,2,0,22,2,100,5
Senegal,2009,9,3,3,0,100,0,3,0,4,3,100,3
Senegal,2010,3,1,1,0,100,0,1,0,2,1,100,3
Senegal,2011,21,4,4,0,100,0,4,0,6,3,75,5.25
Senegal,2012,16,12,12,0,100,0,12,0,40,7,58.33333333,1.333333333
Senegal,2013,7,3,3,0,100,0,3,0,1,2,66.66666667,2.333333333
Senegal,2014,7,2,2,0,100,0,2,0,3,1,50,3.5
Senegal,2015,0,2,2,0,100,0,2,0,4,0,0,0
Serbia,2008,2,4,4,0,100,0,4,0,0,1,25,0.5
Serbia,2009,0,3,2,1,66.66666667,0,3,0,2,0,0,0
Serbia,2010,0,1,1,0,100,0,1,0,4,0,0,0
Serbia,2012,1,3,3,0,100,0,3,0,2,1,33.33333333,0.333333333
Serbia,2017,0,1,1,0,100,0,1,0,1,0,0,0
Serbia-Montenegro,2003,2,6,5,1,83.33333333,0,6,0,4,2,33.33333333,0.333333333
Serbia-Montenegro,2004,1,1,1,0,100,0,1,0,0,1,100,1
Serbia-Montenegro,2005,0,2,2,0,100,0,2,0,0,0,0,0
Serbia-Montenegro,2006,0,2,2,0,100,0,2,0,1,0,0,0
Seychelles,1981,0,2,2,0,100,0,2,0,0,0,0,0
Sierra Leone,1991,128,9,9,0,100,0,9,0,0,4,44.44444444,14.22222222
Sierra Leone,1992,21,4,3,1,75,0,4,0,4,3,75,5.25
Sierra Leone,1994,228,22,21,1,95.45454545,0,22,0,33,14,63.63636364,10.36363636
Sierra Leone,1995,40,14,14,0,100,0,14,0,23,8,57.14285714,2.857142857
Sierra Leone,1996,60,5,4,1,80,0,5,0,11,3,60,12
Sierra Leone,1997,16,3,3,0,100,0,3,0,1,3,100,5.333333333
Sierra Leone,1998,258,7,7,0,100,0,7,0,19,5,71.42857143,36.85714286
Sierra Leone,1999,28,9,9,0,100,0,9,0,0,2,22.22222222,3.111111111
Sierra Leone,2000,60,24,24,0,100,0,24,0,31,10,41.66666667,2.5
Sierra Leone,2016,1,1,1,0,100,0,1,0,0,1,100,1
Sierra Leone,2017,0,3,3,0,100,0,3,0,0,0,0,0
Singapore,1974,0,1,1,0,100,0,1,0,0,0,0,0
Singapore,1985,0,1,1,0,100,0,1,0,0,0,0,0
Singapore,1987,0,2,2,0,100,0,2,0,0,0,0,0
Singapore,1991,4,1,1,0,100,0,1,0,2,1,100,4
Singapore,1992,0,1,1,0,100,0,1,0,0,0,0,0
Singapore,1994,1,1,1,0,100,0,1,0,1,1,100,1
Slovakia,1994,0,1,1,0,100,0,1,0,0,0,0,0
Slovakia,1995,3,3,3,0,100,0,3,0,1,2,66.66666667,1
Slovakia,1996,1,5,4,1,80,0,5,0,0,1,20,0.2
Slovakia,1997,2,4,2,2,50,0,4,0,1,2,50,0.5
Slovakia,1998,1,2,2,0,100,0,2,0,3,1,50,0.5
Slovakia,1999,0,1,1,0,100,0,1,0,1,0,0,0
Slovakia,2000,0,1,1,0,100,0,1,0,4,0,0,0
Slovakia,2016,0,1,1,0,100,0,1,0,1,0,0,0
Slovenia,1994,1,1,1,0,100,0,1,0,1,1,100,1
Slovenia,1996,0,3,3,0,100,0,3,0,1,0,0,0
Slovenia,1997,0,1,1,0,100,0,1,0,0,0,0,0
Slovenia,2000,0,1,1,0,100,0,1,0,0,0,0,0
Solomon Islands,1999,2,1,1,0,100,0,1,0,0,1,100,2
Solomon Islands,2000,0,1,1,0,100,0,1,0,0,0,0,0
Solomon Islands,2002,1,1,1,0,100,0,1,0,0,1,100,1
Solomon Islands,2003,1,1,1,0,100,0,1,0,0,1,100,1
Somalia,1975,0,1,1,0,100,0,1,0,0,0,0,0
Somalia,1980,1,1,0,1,0,0,1,0,0,1,100,1
Somalia,1981,0,8,8,0,100,0,8,0,2,0,0,0
Somalia,1983,0,1,1,0,100,0,1,0,0,0,0,0
Somalia,1984,0,2,2,0,100,0,2,0,2,0,0,0
Somalia,1987,0,1,1,0,100,0,1,0,0,0,0,0
Somalia,1988,0,2,2,0,100,0,2,0,5,0,0,0
Somalia,1989,30,2,2,0,100,0,2,0,0,1,50,15
Somalia,1990,5,12,12,0,100,0,12,0,0,4,33.33333333,0.416666667
Somalia,1991,6,8,8,0,100,0,8,0,0,4,50,0.75
Somalia,1992,8,21,19,2,90.47619048,0,21,0,12,5,23.80952381,0.380952381
Somalia,1994,78,57,53,4,92.98245614,0,57,0,116,25,43.85964912,1.368421053
Somalia,1995,29,13,13,0,100,0,13,0,162,6,46.15384615,2.230769231
Somalia,1996,28,16,16,0,100,0,16,0,8,11,68.75,1.75
Somalia,1997,145,19,19,0,100,0,19,0,138,13,68.42105263,7.631578947
Somalia,1998,0,1,1,0,100,0,1,0,0,0,0,0
Somalia,1999,9,4,4,0,100,0,4,0,6,4,100,2.25
Somalia,2000,36,9,9,0,100,0,9,0,39,6,66.66666667,4
Somalia,2001,3,5,2,3,40,0,5,0,0,1,20,0.6
Somalia,2002,6,3,3,0,100,0,3,0,6,1,33.33333333,2
Somalia,2003,7,1,1,0,100,0,1,0,0,1,100,7
Somalia,2004,2,1,1,0,100,0,1,0,1,1,100,2
Somalia,2005,20,6,6,0,100,0,6,0,56,4,66.66666667,3.333333333
Somalia,2006,22,10,10,0,100,2,8,20,35,7,70,2.2
Somalia,2007,408,156,151,5,96.79487179,3,153,1.923076923,554,107,68.58974359,2.615384615
Somalia,2008,436,172,153,19,88.95348837,3,169,1.744186047,564,104,60.46511628,2.534883721
Somalia,2009,381,122,119,3,97.54098361,2,120,1.639344262,605,74,60.6557377,3.12295082
Somalia,2010,295,130,120,10,92.30769231,4,126,3.076923077,395,69,53.07692308,2.269230769
Somalia,2011,344,185,175,10,94.59459459,8,177,4.324324324,640,92,49.72972973,1.859459459
Somalia,2012,783,325,305,20,93.84615385,17,308,5.230769231,727,194,59.69230769,2.409230769
Somalia,2013,660,342,318,24,92.98245614,17,325,4.970760234,604,184,53.80116959,1.929824561
Somalia,2014,1589,872,824,48,94.49541284,24,848,2.752293578,780,459,52.63761468,1.822247706
Somalia,2015,1447,418,374,44,89.47368421,25,393,5.980861244,806,249,59.56937799,3.461722488
Somalia,2016,1583,602,526,76,87.37541528,40,562,6.644518272,1325,327,54.31893688,2.629568106
Somalia,2017,1912,614,545,69,88.76221498,43,571,7.003257329,1287,358,58.30618893,3.114006515
South Africa,1974,0,1,1,0,100,0,1,0,1,0,0,0
South Africa,1976,2,1,1,0,100,0,1,0,0,1,100,2
South Africa,1977,5,15,13,2,86.66666667,0,15,0,35,4,26.66666667,0.333333333
South Africa,1978,6,9,7,2,77.77777778,0,9,0,3,5,55.55555556,0.666666667
South Africa,1979,8,16,13,3,81.25,0,16,0,30,6,37.5,0.5
South Africa,1980,26,23,20,3,86.95652174,0,23,0,31,12,52.17391304,1.130434783
South Africa,1981,8,42,40,2,95.23809524,0,42,0,24,5,11.9047619,0.19047619
South Africa,1982,9,26,26,0,100,0,26,0,74,5,19.23076923,0.346153846
South Africa,1983,28,56,47,9,83.92857143,0,56,0,316,6,10.71428571,0.5
South Africa,1984,21,60,58,2,96.66666667,0,60,0,83,13,21.66666667,0.35
South Africa,1985,82,106,95,11,89.62264151,0,106,0,251,27,25.47169811,0.773584906
South Africa,1986,153,159,145,14,91.19496855,0,159,0,437,53,33.33333333,0.962264151
South Africa,1987,120,133,122,11,91.72932331,0,133,0,388,43,32.33082707,0.902255639
South Africa,1988,152,245,230,15,93.87755102,0,245,0,606,59,24.08163265,0.620408163
South Africa,1989,57,149,138,11,92.61744966,1,148,0.67114094,141,30,20.13422819,0.382550336
South Africa,1990,150,154,147,7,95.45454545,0,154,0,293,55,35.71428571,0.974025974
South Africa,1991,384,127,121,6,95.27559055,0,127,0,387,86,67.71653543,3.023622047
South Africa,1992,706,271,264,7,97.41697417,0,271,0,447,220,81.18081181,2.605166052
South Africa,1994,447,174,161,13,92.52873563,0,174,0,581,120,68.96551724,2.568965517
South Africa,1995,105,32,30,2,93.75,0,32,0,88,26,81.25,3.28125
South Africa,1996,82,47,47,0,100,0,47,0,106,21,44.68085106,1.744680851
South Africa,1997,23,17,16,1,94.11764706,0,17,0,4,11,64.70588235,1.352941176
South Africa,1998,13,6,5,1,83.33333333,0,6,0,31,3,50,2.166666667
South Africa,1999,4,17,15,2,88.23529412,0,17,0,74,3,17.64705882,0.235294118
South Africa,2000,18,21,18,3,85.71428571,0,21,0,45,7,33.33333333,0.857142857
South Africa,2002,1,8,7,1,87.5,0,8,0,1,1,12.5,0.125
South Africa,2007,1,2,2,0,100,0,2,0,1,1,50,0.5
South Africa,2008,0,1,1,0,100,0,1,0,0,0,0,0
South Africa,2012,5,4,4,0,100,0,4,0,4,4,100,1.25
South Africa,2013,2,13,10,3,76.92307692,0,13,0,5,2,15.38461538,0.153846154
South Africa,2014,9,20,19,1,95,0,20,0,8,4,20,0.45
South Africa,2015,5,5,5,0,100,0,5,0,32,4,80,1
South Africa,2016,21,27,24,3,88.88888889,0,27,0,11,20,74.07407407,0.777777778
South Africa,2017,21,29,25,4,86.20689655,0,29,0,7,21,72.4137931,0.724137931
South America,1970,11,65,60,5,92.30769231,0,65,0,4,10,15.38461538,0.169230769
South America,1971,6,24,24,0,100,0,24,0,0,4,16.66666667,0.25
South America,1972,6,33,18,15,54.54545455,0,33,0,1,6,18.18181818,0.181818182
South America,1973,16,83,78,5,93.97590361,0,83,0,19,16,19.27710843,0.192771084
South America,1974,21,81,78,3,96.2962963,0,81,0,29,15,18.51851852,0.259259259
South America,1975,130,55,52,3,94.54545455,0,55,0,16,11,20,2.363636364
South America,1976,134,91,83,8,91.20879121,0,91,0,106,33,36.26373626,1.472527473
South America,1977,47,119,113,6,94.95798319,0,119,0,42,28,23.52941176,0.394957983
South America,1978,93,222,213,9,95.94594595,0,222,0,51,54,24.32432432,0.418918919
South America,1979,183,236,217,19,91.94915254,0,236,0,77,83,35.16949153,0.775423729
South America,1980,206,319,265,54,83.07210031,0,319,0,123,72,22.57053292,0.645768025
South America,1981,402,383,352,31,91.90600522,0,383,0,76,106,27.67624021,1.049608355
South America,1982,672,639,598,41,93.58372457,0,639,0,186,176,27.54303599,1.051643192
South America,1983,2279,950,888,62,93.47368421,0,950,0,383,389,40.94736842,2.398947368
South America,1984,2995,1492,1423,69,95.37533512,0,1492,0,984,402,26.94369973,2.007372654
South America,1985,1700,1040,949,91,91.25,0,1040,0,652,290,27.88461538,1.634615385
South America,1986,1351,1184,1126,58,95.10135135,0,1184,0,522,357,30.15202703,1.141047297
South America,1987,1450,1265,1190,75,94.07114625,0,1265,0,718,394,31.14624506,1.146245059
South America,1988,2024,1041,978,63,93.9481268,0,1041,0,782,448,43.03554275,1.944284342
South America,1989,2339,1385,1326,59,95.7400722,0,1385,0,895,521,37.61732852,1.688808664
South America,1990,1861,1076,1027,49,95.44609665,0,1076,0,1069,428,39.77695167,1.729553903
South America,1991,2238,1322,1233,89,93.2677761,0,1322,0,896,443,33.50983359,1.692889561
South America,1992,1536,1204,1076,128,89.36877076,1,1203,0.083056478,1497,387,32.14285714,1.275747508
South America,1994,406,373,338,35,90.61662198,1,372,0.268096515,495,92,24.66487936,1.08847185
South America,1995,650,255,228,27,89.41176471,0,255,0,472,92,36.07843137,2.549019608
South America,1996,725,517,471,46,91.10251451,0,517,0,582,216,41.7794971,1.402321083
South America,1997,1317,774,727,47,93.92764858,0,774,0,756,309,39.92248062,1.701550388
South America,1998,599,108,103,5,95.37037037,0,108,0,191,30,27.77777778,5.546296296
South America,1999,293,134,124,10,92.53731343,0,134,0,250,40,29.85074627,2.186567164
South America,2000,430,150,142,8,94.66666667,0,150,0,191,51,34,2.866666667
South America,2001,593,229,212,17,92.57641921,0,229,0,446,101,44.10480349,2.589519651
South America,2002,369,162,154,8,95.0617284,0,162,0,690,71,43.82716049,2.277777778
South America,2003,191,117,110,7,94.01709402,3,114,2.564102564,575,44,37.60683761,1.632478632
South America,2004,89,42,39,3,92.85714286,1,41,2.380952381,218,23,54.76190476,2.119047619
South America,2005,152,49,48,1,97.95918367,0,49,0,108,32,65.30612245,3.102040816
South America,2006,93,50,48,2,96,0,50,0,106,28,56,1.86
South America,2007,83,47,46,1,97.87234043,0,47,0,163,26,55.31914894,1.765957447
South America,2008,109,144,126,18,87.5,0,144,0,253,40,27.77777778,0.756944444
South America,2009,136,159,143,16,89.93710692,0,159,0,244,45,28.30188679,0.855345912
South America,2010,58,148,112,36,75.67567568,0,148,0,149,18,12.16216216,0.391891892
South America,2011,43,106,90,16,84.90566038,0,106,0,90,26,24.52830189,0.405660377
South America,2012,180,133,126,7,94.73684211,0,133,0,470,55,41.35338346,1.353383459
South America,2013,160,182,166,16,91.20879121,0,182,0,292,69,37.91208791,0.879120879
South America,2014,157,283,246,37,86.92579505,0,283,0,355,82,28.97526502,0.554770318
South America,2015,128,176,154,22,87.5,0,176,0,145,61,34.65909091,0.727272727
South America,2016,87,159,141,18,88.67924528,0,159,0,179,47,29.55974843,0.547169811
South America,2017,101,172,159,13,92.44186047,0,172,0,156,65,37.79069767,0.587209302
South Asia,1970,4,1,1,0,100,0,1,0,20,1,100,4
South Asia,1971,0,0,0,0,0,0,0,0,0,0,,
South Asia,1972,0,1,1,0,100,0,1,0,0,0,0,0
South Asia,1973,0,1,0,1,0,0,1,0,1,0,0,0
South Asia,1974,0,2,2,0,100,0,2,0,2,0,0,0
South Asia,1975,6,4,4,0,100,0,4,0,0,3,75,1.5
South Asia,1976,1,4,4,0,100,0,4,0,3,1,25,0.25
South Asia,1977,0,2,2,0,100,0,2,0,1,0,0,0
South Asia,1978,5,2,2,0,100,0,2,0,2,2,100,2.5
South Asia,1979,92,34,32,2,94.11764706,0,34,0,63,22,64.70588235,2.705882353
South Asia,1980,40,12,10,2,83.33333333,0,12,0,111,9,75,3.333333333
South Asia,1981,37,23,22,1,95.65217391,0,23,0,24,12,52.17391304,1.608695652
South Asia,1982,74,20,17,3,85,0,20,0,115,13,65,3.7
South Asia,1983,75,63,55,8,87.3015873,0,63,0,252,25,39.68253968,1.19047619
South Asia,1984,693,244,226,18,92.62295082,0,244,0,638,129,52.86885246,2.840163934
South Asia,1985,668,161,147,14,91.30434783,0,161,0,408,96,59.62732919,4.149068323
South Asia,1986,1144,273,255,18,93.40659341,0,273,0,1694,187,68.4981685,4.19047619
South Asia,1987,1989,348,326,22,93.67816092,1,347,0.287356322,2309,248,71.26436782,5.715517241
South Asia,1988,2221,801,762,39,95.13108614,0,801,0,2653,560,69.91260924,2.77278402
South Asia,1989,2893,926,890,36,96.11231102,0,926,0,2037,610,65.87473002,3.124190065
South Asia,1990,2678,601,579,22,96.33943428,1,600,0.166389351,2138,401,66.72212978,4.455906822
South Asia,1991,2515,677,637,40,94.0915805,3,674,0.443131462,2892,395,58.34564254,3.714918759
South Asia,1992,2447,545,517,28,94.86238532,1,544,0.183486239,2481,354,64.95412844,4.489908257
South Asia,1994,985,376,358,18,95.21276596,3,373,0.79787234,1987,198,52.65957447,2.619680851
South Asia,1995,2133,1051,965,86,91.81731684,13,1038,1.236917222,2732,524,49.85727878,2.029495718
South Asia,1996,1945,739,675,64,91.33964817,6,733,0.811907984,5423,420,56.83355886,2.631935047
South Asia,1997,1815,490,467,23,95.30612245,5,485,1.020408163,2879,384,78.36734694,3.704081633
South Asia,1998,1237,136,132,4,97.05882353,12,124,8.823529412,1450,112,82.35294118,9.095588235
South Asia,1999,900,225,205,20,91.11111111,12,213,5.333333333,1656,152,67.55555556,4
South Asia,2000,1378,357,340,17,95.23809524,17,340,4.761904762,2364,206,57.70308123,3.859943978
South Asia,2001,1367,385,362,23,94.02597403,14,371,3.636363636,2288,254,65.97402597,3.550649351
South Asia,2002,1288,334,302,32,90.41916168,8,326,2.395209581,2415,189,56.58682635,3.856287425
South Asia,2003,802,353,332,21,94.0509915,8,345,2.266288952,1604,198,56.09065156,2.271954674
South Asia,2004,1616,369,341,28,92.41192412,11,358,2.98102981,2710,239,64.7696477,4.379403794
South Asia,2005,1365,604,581,23,96.19205298,27,577,4.470198675,2883,363,60.09933775,2.259933775
South Asia,2006,2937,938,911,27,97.12153518,70,868,7.462686567,5142,550,58.63539446,3.131130064
South Asia,2007,3686,982,952,30,96.94501018,143,839,14.56211813,5324,659,67.10794297,3.753564155
South Asia,2008,3517,1759,1623,136,92.26833428,113,1646,6.424104605,6427,888,50.48322911,1.999431495
South Asia,2009,3565,1945,1855,90,95.37275064,105,1840,5.398457584,6729,933,47.96915167,1.832904884
South Asia,2010,3695,1981,1848,133,93.28621908,87,1894,4.391721353,5396,956,48.25845533,1.865219586
South Asia,2011,3725,2138,1985,153,92.84377923,123,2015,5.753040225,5408,1077,50.37418148,1.742282507
South Asia,2012,6586,3803,3315,488,87.16802524,189,3614,4.969760715,9640,1970,51.80120957,1.731790692
South Asia,2013,7070,4612,3882,730,84.17172593,213,4399,4.618386817,11098,2118,45.92367736,1.532957502
South Asia,2014,8358,4998,4336,662,86.75470188,231,4767,4.621848739,9461,2449,48.99959984,1.672268908
South Asia,2015,8300,4585,3720,865,81.13413304,188,4397,4.100327154,10233,2084,45.4525627,1.810250818
South Asia,2016,7803,3639,2754,885,75.6801319,151,3488,4.149491619,9277,1786,49.07941742,2.144270404
South Asia,2017,7664,3430,2637,793,76.88046647,171,3259,4.985422741,8990,1594,46.47230321,2.234402332
South Korea,1974,1,1,1,0,100,0,1,0,0,1,100,1
South Korea,1982,1,1,1,0,100,0,1,0,3,1,100,1
South Korea,1983,1,1,1,0,100,0,1,0,4,1,100,1
South Korea,1986,5,2,2,0,100,0,2,0,30,1,50,2.5
South Korea,1988,0,8,7,1,87.5,0,8,0,0,0,0,0
South Korea,1989,0,1,1,0,100,0,1,0,0,0,0,0
South Korea,1990,0,3,2,1,66.66666667,0,3,0,1,0,0,0
South Korea,1991,0,6,5,1,83.33333333,0,6,0,0,0,0,0
South Korea,1992,1,3,3,0,100,0,3,0,0,1,33.33333333,0.333333333
South Korea,1994,1,2,2,0,100,0,2,0,1,1,50,0.5
South Korea,1995,0,4,4,0,100,0,4,0,1,0,0,0
South Korea,1996,0,1,1,0,100,0,1,0,30,0,0,0
South Korea,2001,0,1,1,0,100,0,1,0,2,0,0,0
South Korea,2003,0,1,1,0,100,0,1,0,60,0,0,0
South Korea,2006,0,1,1,0,100,0,1,0,1,0,0,0
South Korea,2015,0,1,0,1,0,0,1,0,1,0,0,0
South Korea,2016,0,1,1,0,100,0,1,0,0,0,0,0
South Sudan,2012,68,5,4,1,80,0,5,0,22,3,60,13.6
South Sudan,2013,226,13,13,0,100,0,13,0,113,9,69.23076923,17.38461538
South Sudan,2014,908,40,39,1,97.5,0,40,0,602,29,72.5,22.7
South Sudan,2015,218,54,45,9,83.33333333,1,53,1.851851852,137,28,51.85185185,4.037037037
South Sudan,2016,633,59,54,5,91.52542373,0,59,0,191,39,66.10169492,10.72881356
South Sudan,2017,581,54,38,16,70.37037037,0,54,0,258,35,64.81481481,10.75925926
South Vietnam,1972,81,1,1,0,100,0,1,0,0,1,100,81
South Yemen,1971,0,1,1,0,100,0,1,0,0,0,0,0
South Yemen,1983,0,1,1,0,100,0,1,0,2,0,0,0
Southeast Asia,1970,41,10,9,1,90,0,10,0,13,5,50,4.1
Southeast Asia,1971,2,6,5,1,83.33333333,0,6,0,10,1,16.66666667,0.333333333
Southeast Asia,1972,84,16,9,7,56.25,0,16,0,1,4,25,5.25
Southeast Asia,1973,0,2,2,0,100,0,2,0,8,0,0,0
Southeast Asia,1974,5,3,3,0,100,0,3,0,0,2,66.66666667,1.666666667
Southeast Asia,1975,1,7,7,0,100,0,7,0,48,1,14.28571429,0.142857143
Southeast Asia,1976,47,12,12,0,100,0,12,0,73,5,41.66666667,3.916666667
Southeast Asia,1977,102,8,7,1,87.5,0,8,0,72,3,37.5,12.75
Southeast Asia,1978,158,44,43,1,97.72727273,0,44,0,219,24,54.54545455,3.590909091
Southeast Asia,1979,260,86,82,4,95.34883721,0,86,0,300,57,66.27906977,3.023255814
Southeast Asia,1980,244,87,77,10,88.50574713,0,87,0,719,39,44.82758621,2.804597701
Southeast Asia,1981,201,50,50,0,100,0,50,0,424,25,50,4.02
Southeast Asia,1982,143,43,40,3,93.02325581,0,43,0,270,28,65.11627907,3.325581395
Southeast Asia,1983,122,22,21,1,95.45454545,0,22,0,80,12,54.54545455,5.545454545
Southeast Asia,1984,264,46,44,2,95.65217391,0,46,0,128,41,89.13043478,5.739130435
Southeast Asia,1985,459,128,125,3,97.65625,0,128,0,391,69,53.90625,3.5859375
Southeast Asia,1986,342,102,95,7,93.1372549,0,102,0,414,67,65.68627451,3.352941176
Southeast Asia,1987,404,163,150,13,92.02453988,0,163,0,485,87,53.37423313,2.478527607
Southeast Asia,1988,662,242,224,18,92.56198347,0,242,0,507,170,70.24793388,2.73553719
Southeast Asia,1989,606,203,196,7,96.55172414,0,203,0,479,126,62.06896552,2.985221675
Southeast Asia,1990,562,348,317,31,91.09195402,0,348,0,448,144,41.37931034,1.614942529
Southeast Asia,1991,574,206,191,15,92.7184466,0,206,0,429,102,49.51456311,2.786407767
Southeast Asia,1992,673,279,265,14,94.98207885,0,279,0,768,140,50.17921147,2.41218638
Southeast Asia,1994,390,151,144,7,95.36423841,0,151,0,378,73,48.34437086,2.582781457
Southeast Asia,1995,312,168,159,9,94.64285714,0,168,0,310,60,35.71428571,1.857142857
Southeast Asia,1996,270,193,182,11,94.30051813,0,193,0,511,72,37.30569948,1.398963731
Southeast Asia,1997,335,159,153,6,96.22641509,0,159,0,690,73,45.91194969,2.106918239
Southeast Asia,1998,54,32,28,4,87.5,0,32,0,137,12,37.5,1.6875
Southeast Asia,1999,123,107,98,9,91.58878505,0,107,0,305,45,42.05607477,1.14953271
Southeast Asia,2000,459,256,229,27,89.453125,3,253,1.171875,1054,106,41.40625,1.79296875
Southeast Asia,2001,311,185,162,23,87.56756757,1,184,0.540540541,538,82,44.32432432,1.681081081
Southeast Asia,2002,396,110,105,5,95.45454545,2,108,1.818181818,956,59,53.63636364,3.6
Southeast Asia,2003,354,145,135,10,93.10344828,3,142,2.068965517,759,77,53.10344828,2.44137931
Southeast Asia,2004,281,95,88,7,92.63157895,1,94,1.052631579,551,56,58.94736842,2.957894737
Southeast Asia,2005,266,204,193,11,94.60784314,2,202,0.980392157,846,125,61.2745098,1.303921569
Southeast Asia,2006,260,272,266,6,97.79411765,0,272,0,582,163,59.92647059,0.955882353
Southeast Asia,2007,390,365,350,15,95.89041096,0,365,0,1057,187,51.23287671,1.068493151
Southeast Asia,2008,403,514,463,51,90.07782101,1,513,0.194552529,1060,217,42.21789883,0.784046693
Southeast Asia,2009,482,561,524,37,93.40463458,2,559,0.356506239,892,302,53.83244207,0.859180036
Southeast Asia,2010,322,473,444,29,93.86892178,2,471,0.422832981,634,207,43.76321353,0.680761099
Southeast Asia,2011,299,356,326,30,91.57303371,2,354,0.561797753,730,171,48.03370787,0.83988764
Southeast Asia,2012,453,587,528,59,89.94889267,0,587,0,1526,237,40.37478705,0.771720613
Southeast Asia,2013,723,1188,1031,157,86.78451178,2,1186,0.168350168,1392,412,34.68013468,0.608585859
Southeast Asia,2014,702,1082,944,138,87.24584104,0,1082,0,1451,374,34.56561922,0.648798521
Southeast Asia,2015,646,1072,880,192,82.08955224,0,1072,0,1386,390,36.38059701,0.60261194
Southeast Asia,2016,639,1077,889,188,82.54410399,4,1073,0.371402043,1220,389,36.11884865,0.593314763
Southeast Asia,2017,811,1020,856,164,83.92156863,3,1017,0.294117647,1008,407,39.90196078,0.795098039
Soviet Union,1978,4,1,1,0,100,0,1,0,0,1,100,4
Spain,1970,0,4,3,1,75,0,4,0,0,0,0,0
Spain,1971,0,22,21,1,95.45454545,0,22,0,0,0,0,0
Spain,1972,2,19,19,0,100,0,19,0,3,2,10.52631579,0.105263158
Spain,1973,6,21,21,0,100,0,21,0,2,4,19.04761905,0.285714286
Spain,1974,19,14,14,0,100,0,14,0,70,7,50,1.357142857
Spain,1975,31,136,133,3,97.79411765,0,136,0,2,27,19.85294118,0.227941176
Spain,1976,17,50,49,1,98,0,50,0,5,11,22,0.34
Spain,1977,44,147,130,17,88.43537415,0,147,0,101,25,17.00680272,0.299319728
Spain,1978,84,209,182,27,87.08133971,0,209,0,123,60,28.70813397,0.401913876
Spain,1979,112,279,232,47,83.15412186,0,279,0,284,85,30.46594982,0.401433692
Spain,1980,116,187,162,25,86.63101604,0,187,0,184,80,42.78074866,0.620320856
Spain,1981,39,107,95,12,88.78504673,0,107,0,85,30,28.03738318,0.364485981
Spain,1982,42,146,136,10,93.15068493,0,146,0,53,34,23.28767123,0.287671233
Spain,1983,42,122,107,15,87.70491803,0,122,0,70,34,27.86885246,0.344262295
Spain,1984,51,143,132,11,92.30769231,0,143,0,77,38,26.57342657,0.356643357
Spain,1985,67,114,106,8,92.98245614,0,114,0,182,44,38.59649123,0.587719298
Spain,1986,57,125,112,13,89.6,0,125,0,196,27,21.6,0.456
Spain,1987,68,104,89,15,85.57692308,0,104,0,211,23,22.11538462,0.653846154
Spain,1988,25,151,134,17,88.74172185,0,151,0,144,20,13.24503311,0.165562914
Spain,1989,29,142,102,40,71.83098592,0,142,0,35,21,14.78873239,0.204225352
Spain,1990,32,113,83,30,73.45132743,0,113,0,138,19,16.81415929,0.283185841
Spain,1991,46,89,72,17,80.8988764,0,89,0,164,28,31.46067416,0.516853933
Spain,1992,29,72,57,15,79.16666667,0,72,0,83,21,29.16666667,0.402777778
Spain,1994,17,55,43,12,78.18181818,0,55,0,31,14,25.45454545,0.309090909
Spain,1995,18,44,42,2,95.45454545,0,44,0,86,12,27.27272727,0.409090909
Spain,1996,5,63,45,18,71.42857143,0,63,0,63,5,7.936507937,0.079365079
Spain,1997,11,86,70,16,81.39534884,0,86,0,25,11,12.79069767,0.127906977
Spain,1998,6,17,15,2,88.23529412,0,17,0,6,5,29.41176471,0.352941176
Spain,1999,0,47,38,9,80.85106383,0,47,0,2,0,0,0
Spain,2000,29,112,93,19,83.03571429,0,112,0,93,18,16.07142857,0.258928571
Spain,2001,14,79,70,9,88.60759494,0,79,0,174,12,15.18987342,0.17721519
Spain,2002,5,41,38,3,92.68292683,0,41,0,73,4,9.756097561,0.12195122
Spain,2003,3,21,16,5,76.19047619,0,21,0,25,2,9.523809524,0.142857143
Spain,2004,193,31,26,5,83.87096774,0,31,0,1811,5,16.12903226,6.225806452
Spain,2005,0,24,24,0,100,0,24,0,82,0,0,0
Spain,2006,2,23,23,0,100,0,23,0,24,1,4.347826087,0.086956522
Spain,2007,0,11,10,1,90.90909091,0,11,0,5,0,0,0
Spain,2008,3,37,35,2,94.59459459,0,37,0,59,3,8.108108108,0.081081081
Spain,2009,3,21,21,0,100,0,21,0,48,2,9.523809524,0.142857143
Spain,2010,0,3,3,0,100,0,3,0,0,0,0,0
Spain,2012,0,1,0,1,0,0,1,0,0,0,0,0
Spain,2013,0,5,4,1,80,0,5,0,1,0,0,0
Spain,2014,0,4,3,1,75,1,3,25,0,0,0,0
Spain,2015,0,1,1,0,100,0,1,0,0,0,0,0
Spain,2016,0,3,3,0,100,0,3,0,4,0,0,0
Spain,2017,21,4,4,0,100,1,3,25,111,3,75,5.25
Sri Lanka,1975,1,1,1,0,100,0,1,0,0,1,100,1
Sri Lanka,1979,2,3,3,0,100,0,3,0,1,2,66.66666667,0.666666667
Sri Lanka,1981,3,2,2,0,100,0,2,0,6,1,50,1.5
Sri Lanka,1982,7,2,2,0,100,0,2,0,0,2,100,3.5
Sri Lanka,1983,6,7,7,0,100,0,7,0,9,4,57.14285714,0.857142857
Sri Lanka,1984,485,81,76,5,93.82716049,0,81,0,225,44,54.32098765,5.987654321
Sri Lanka,1985,611,110,103,7,93.63636364,0,110,0,293,68,61.81818182,5.554545455
Sri Lanka,1986,690,142,131,11,92.25352113,0,142,0,917,84,59.15492958,4.85915493
Sri Lanka,1987,1274,115,107,8,93.04347826,1,114,0.869565217,781,85,73.91304348,11.07826087
Sri Lanka,1988,885,350,337,13,96.28571429,0,350,0,981,227,64.85714286,2.528571429
Sri Lanka,1989,1822,510,495,15,97.05882353,0,510,0,740,324,63.52941176,3.57254902
Sri Lanka,1990,1505,141,139,2,98.58156028,1,140,0.709219858,356,97,68.79432624,10.67375887
Sri Lanka,1991,1034,115,111,4,96.52173913,2,113,1.739130435,386,83,72.17391304,8.991304348
Sri Lanka,1992,984,103,100,3,97.08737864,1,102,0.970873786,449,90,87.37864078,9.553398058
Sri Lanka,1994,186,35,33,2,94.28571429,3,32,8.571428571,446,23,65.71428571,5.314285714
Sri Lanka,1995,1020,126,110,16,87.3015873,11,115,8.73015873,599,92,73.01587302,8.095238095
Sri Lanka,1996,827,176,156,20,88.63636364,6,170,3.409090909,2216,113,64.20454545,4.698863636
Sri Lanka,1997,486,64,62,2,96.875,5,59,7.8125,544,48,75,7.59375
Sri Lanka,1998,680,35,32,3,91.42857143,9,26,25.71428571,659,28,80,19.42857143
Sri Lanka,1999,212,46,42,4,91.30434783,11,35,23.91304348,579,34,73.91304348,4.608695652
Sri Lanka,2000,449,68,61,7,89.70588235,16,52,23.52941176,950,49,72.05882353,6.602941176
Sri Lanka,2001,195,36,35,1,97.22222222,6,30,16.66666667,503,28,77.77777778,5.416666667
Sri Lanka,2002,3,3,3,0,100,0,3,0,0,2,66.66666667,1
Sri Lanka,2003,23,9,9,0,100,1,8,11.11111111,7,8,88.88888889,2.555555556
Sri Lanka,2004,30,33,29,4,87.87878788,1,32,3.03030303,46,22,66.66666667,0.909090909
Sri Lanka,2005,125,133,126,7,94.73684211,0,133,0,319,73,54.88721805,0.939849624
Sri Lanka,2006,1012,217,208,9,95.85253456,9,208,4.147465438,1262,153,70.50691244,4.66359447
Sri Lanka,2007,410,132,120,12,90.90909091,6,126,4.545454545,561,98,74.24242424,3.106060606
Sri Lanka,2008,353,100,95,5,95,13,87,13,1059,69,69,3.53
Sri Lanka,2009,201,37,35,2,94.59459459,12,25,32.43243243,549,27,72.97297297,5.432432432
Sri Lanka,2010,2,3,3,0,100,0,3,0,4,1,33.33333333,0.666666667
Sri Lanka,2012,0,4,3,1,75,0,4,0,1,0,0,0
Sri Lanka,2013,0,14,10,4,71.42857143,0,14,0,29,0,0,0
Sri Lanka,2014,3,16,15,1,93.75,0,16,0,65,3,18.75,0.1875
Sri Lanka,2015,3,11,9,2,81.81818182,0,11,0,14,2,18.18181818,0.272727273
Sri Lanka,2016,0,1,1,0,100,0,1,0,2,0,0,0
Sri Lanka,2017,1,41,38,3,92.68292683,0,41,0,3,1,2.43902439,0.024390244
Sub-Saharan Africa,1970,1,3,3,0,100,0,3,0,0,1,33.33333333,0.333333333
Sub-Saharan Africa,1971,1,2,2,0,100,0,2,0,0,1,50,0.5
Sub-Saharan Africa,1972,0,4,0,4,0,0,4,0,0,0,0,0
Sub-Saharan Africa,1973,5,4,4,0,100,0,4,0,2,2,50,1.25
Sub-Saharan Africa,1974,4,7,7,0,100,0,7,0,1,3,42.85714286,0.571428571
Sub-Saharan Africa,1975,29,12,12,0,100,0,12,0,100,3,25,2.416666667
Sub-Saharan Africa,1976,8,11,9,2,81.81818182,0,11,0,1,4,36.36363636,0.727272727
Sub-Saharan Africa,1977,17,29,27,2,93.10344828,0,29,0,36,12,41.37931034,0.586206897
Sub-Saharan Africa,1978,112,46,44,2,95.65217391,0,46,0,121,20,43.47826087,2.434782609
Sub-Saharan Africa,1979,334,124,118,6,95.16129032,0,124,0,161,57,45.96774194,2.693548387
Sub-Saharan Africa,1980,82,58,51,7,87.93103448,0,58,0,294,30,51.72413793,1.413793103
Sub-Saharan Africa,1981,102,98,90,8,91.83673469,0,98,0,44,29,29.59183673,1.040816327
Sub-Saharan Africa,1982,68,60,57,3,95,0,60,0,130,16,26.66666667,1.133333333
Sub-Saharan Africa,1983,482,106,93,13,87.73584906,0,106,0,682,31,29.24528302,4.547169811
Sub-Saharan Africa,1984,1031,126,120,6,95.23809524,0,126,0,527,48,38.0952381,8.182539683
Sub-Saharan Africa,1985,211,141,127,14,90.07092199,0,141,0,424,42,29.78723404,1.496453901
Sub-Saharan Africa,1986,799,185,170,15,91.89189189,0,185,0,502,68,36.75675676,4.318918919
Sub-Saharan Africa,1987,648,174,163,11,93.67816092,0,174,0,639,63,36.20689655,3.724137931
Sub-Saharan Africa,1988,735,337,319,18,94.65875371,0,337,0,1083,112,33.23442136,2.181008902
Sub-Saharan Africa,1989,1202,291,279,12,95.87628866,1,290,0.343642612,496,123,42.26804124,4.130584192
Sub-Saharan Africa,1990,660,450,437,13,97.11111111,0,450,0,783,116,25.77777778,1.466666667
Sub-Saharan Africa,1991,1347,271,258,13,95.20295203,0,271,0,783,172,63.46863469,4.970479705
Sub-Saharan Africa,1992,2442,570,538,32,94.38596491,0,570,0,1547,378,66.31578947,4.284210526
Sub-Saharan Africa,1994,3232,432,406,26,93.98148148,0,432,0,1185,271,62.73148148,7.481481481
Sub-Saharan Africa,1995,1320,239,227,12,94.9790795,0,239,0,811,158,66.10878661,5.523012552
Sub-Saharan Africa,1996,2558,217,208,9,95.85253456,0,217,0,699,149,68.66359447,11.78801843
Sub-Saharan Africa,1997,2188,279,274,5,98.2078853,0,279,0,1390,180,64.51612903,7.842293907
Sub-Saharan Africa,1998,1437,87,86,1,98.85057471,2,85,2.298850575,4440,66,75.86206897,16.51724138
Sub-Saharan Africa,1999,885,143,137,6,95.8041958,0,143,0,789,78,54.54545455,6.188811189
Sub-Saharan Africa,2000,1026,191,186,5,97.38219895,0,191,0,616,104,54.45026178,5.371727749
Sub-Saharan Africa,2001,1169,162,148,14,91.35802469,0,162,0,654,98,60.49382716,7.216049383
Sub-Saharan Africa,2002,1041,121,117,4,96.69421488,1,120,0.826446281,338,72,59.50413223,8.603305785
Sub-Saharan Africa,2003,555,73,73,0,100,0,73,0,158,53,72.60273973,7.602739726
Sub-Saharan Africa,2004,317,34,33,1,97.05882353,0,34,0,161,28,82.35294118,9.323529412
Sub-Saharan Africa,2005,379,60,58,2,96.66666667,0,60,0,350,44,73.33333333,6.316666667
Sub-Saharan Africa,2006,972,114,111,3,97.36842105,2,112,1.754385965,360,65,57.01754386,8.526315789
Sub-Saharan Africa,2007,1383,302,292,10,96.68874172,4,298,1.324503311,1074,191,63.24503311,4.579470199
Sub-Saharan Africa,2008,1475,380,349,31,91.84210526,3,377,0.789473684,1905,195,51.31578947,3.881578947
Sub-Saharan Africa,2009,1731,283,274,9,96.81978799,3,280,1.060070671,901,162,57.24381625,6.116607774
Sub-Saharan Africa,2010,830,331,310,21,93.65558912,7,324,2.114803625,1142,161,48.64048338,2.50755287
Sub-Saharan Africa,2011,1237,494,455,39,92.10526316,13,481,2.631578947,1613,294,59.51417004,2.504048583
Sub-Saharan Africa,2012,2996,1168,1074,94,91.95205479,53,1115,4.537671233,2536,716,61.30136986,2.565068493
Sub-Saharan Africa,2013,3857,999,928,71,92.89289289,43,956,4.304304304,2407,609,60.96096096,3.860860861
Sub-Saharan Africa,2014,13351,2321,2197,124,94.65747523,69,2252,2.972856527,5316,1338,57.6475657,5.752261956
Sub-Saharan Africa,2015,10763,1964,1791,173,91.19144603,202,1762,10.28513238,6397,1240,63.13645621,5.480142566
Sub-Saharan Africa,2016,6652,2077,1865,212,89.79297063,131,1946,6.307173808,4642,1147,55.2238806,3.202696196
Sub-Saharan Africa,2017,6712,1970,1750,220,88.83248731,206,1764,10.45685279,4617,1218,61.82741117,3.407106599
Sudan,1973,3,1,1,0,100,0,1,0,0,1,100,3
Sudan,1981,2,1,1,0,100,0,1,0,3,1,100,2
Sudan,1982,0,3,2,1,66.66666667,0,3,0,0,0,0,0
Sudan,1983,0,3,3,0,100,0,3,0,0,0,0,0
Sudan,1984,305,5,4,1,80,0,5,0,10,3,60,61
Sudan,1986,8,6,5,1,83.33333333,0,6,0,1,3,50,1.333333333
Sudan,1987,0,1,1,0,100,0,1,0,0,0,0,0
Sudan,1988,58,10,9,1,90,0,10,0,28,5,50,5.8
Sudan,1989,14,8,8,0,100,0,8,0,1,4,50,1.75
Sudan,1990,0,1,1,0,100,0,1,0,0,0,0,0
Sudan,1991,32,3,3,0,100,0,3,0,0,3,100,10.66666667
Sudan,1992,13,7,5,2,71.42857143,0,7,0,0,6,85.71428571,1.857142857
Sudan,1994,17,5,5,0,100,0,5,0,23,2,40,3.4
Sudan,1995,6,4,4,0,100,0,4,0,0,1,25,1.5
Sudan,1996,40,10,10,0,100,0,10,0,10,4,40,4
Sudan,1997,1,3,3,0,100,0,3,0,21,1,33.33333333,0.333333333
Sudan,1999,16,5,5,0,100,0,5,0,6,2,40,3.2
Sudan,2000,27,7,7,0,100,0,7,0,180,3,42.85714286,3.857142857
Sudan,2001,13,9,7,2,77.77777778,0,9,0,3,3,33.33333333,1.444444444
Sudan,2002,589,13,13,0,100,0,13,0,23,12,92.30769231,45.30769231
Sudan,2004,28,5,5,0,100,0,5,0,13,4,80,5.6
Sudan,2005,54,6,6,0,100,0,6,0,26,5,83.33333333,9
Sudan,2006,484,24,24,0,100,0,24,0,153,22,91.66666667,20.16666667
Sudan,2007,317,23,23,0,100,0,23,0,111,21,91.30434783,13.7826087
Sudan,2008,205,32,30,2,93.75,0,32,0,29,17,53.125,6.40625
Sudan,2009,77,26,25,1,96.15384615,0,26,0,36,18,69.23076923,2.961538462
Sudan,2010,81,28,28,0,100,0,28,0,86,10,35.71428571,2.892857143
Sudan,2011,193,38,37,1,97.36842105,0,38,0,123,26,68.42105263,5.078947368
Sudan,2012,60,40,37,3,92.5,0,40,0,95,25,62.5,1.5
Sudan,2013,220,46,45,1,97.82608696,0,46,0,150,30,65.2173913,4.782608696
Sudan,2014,546,157,155,2,98.72611465,0,157,0,320,74,47.13375796,3.477707006
Sudan,2015,210,158,152,6,96.20253165,0,158,0,329,53,33.5443038,1.329113924
Sudan,2016,182,173,166,7,95.95375723,0,173,0,213,66,38.15028902,1.052023121
Sudan,2017,82,106,103,3,97.16981132,0,106,0,176,42,39.62264151,0.773584906
Suriname,1982,0,1,1,0,100,0,1,0,0,0,0,0
Suriname,1983,0,1,1,0,100,0,1,0,2,0,0,0
Suriname,1984,0,1,0,1,0,0,1,0,0,0,0,0
Suriname,1986,2,8,7,1,87.5,0,8,0,3,1,12.5,0.25
Suriname,1987,6,13,12,1,92.30769231,0,13,0,7,4,30.76923077,0.461538462
Suriname,1988,6,9,8,1,88.88888889,0,9,0,4,1,11.11111111,0.666666667
Suriname,1989,14,17,16,1,94.11764706,0,17,0,6,4,23.52941176,0.823529412
Suriname,1990,0,7,7,0,100,0,7,0,0,0,0,0
Suriname,1991,1,1,1,0,100,0,1,0,0,1,100,1
Suriname,1992,0,5,5,0,100,0,5,0,0,0,0,0
Suriname,1994,0,1,1,0,100,0,1,0,0,0,0,0
Suriname,1997,0,2,2,0,100,0,2,0,2,0,0,0
Swaziland,1982,0,1,1,0,100,0,1,0,0,0,0,0
Swaziland,1984,1,1,1,0,100,0,1,0,0,1,100,1
Swaziland,1986,0,1,1,0,100,0,1,0,0,0,0,0
Swaziland,1987,4,1,1,0,100,0,1,0,1,1,100,4
Swaziland,1989,0,1,1,0,100,0,1,0,0,0,0,0
Swaziland,1991,0,1,1,0,100,0,1,0,0,0,0,0
Swaziland,1992,0,1,1,0,100,0,1,0,0,0,0,0
Swaziland,1995,0,1,1,0,100,0,1,0,0,0,0,0
Swaziland,1997,0,1,0,1,0,0,1,0,0,0,0,0
Swaziland,1998,1,1,1,0,100,0,1,0,2,1,100,1
Swaziland,1999,0,1,1,0,100,0,1,0,0,0,0,0
Swaziland,2003,0,1,1,0,100,0,1,0,0,0,0,0
Swaziland,2006,0,1,1,0,100,0,1,0,0,0,0,0
Swaziland,2008,0,3,3,0,100,0,3,0,0,0,0,0
Sweden,1971,1,2,2,0,100,0,2,0,2,1,50,0.5
Sweden,1972,0,3,3,0,100,0,3,0,0,0,0,0
Sweden,1975,3,1,1,0,100,0,1,0,13,1,100,3
Sweden,1978,0,1,1,0,100,0,1,0,0,0,0,0
Sweden,1979,1,1,1,0,100,0,1,0,0,1,100,1
Sweden,1983,1,1,1,0,100,0,1,0,0,1,100,1
Sweden,1986,1,3,3,0,100,0,3,0,1,1,33.33333333,0.333333333
Sweden,1989,0,3,2,1,66.66666667,0,3,0,0,0,0,0
Sweden,1990,1,6,6,0,100,0,6,0,11,1,16.66666667,0.166666667
Sweden,1991,1,6,4,2,66.66666667,0,6,0,1,1,16.66666667,0.166666667
Sweden,1992,2,12,10,2,83.33333333,0,12,0,5,2,16.66666667,0.166666667
Sweden,1994,0,1,0,1,0,0,1,0,1,0,0,0
Sweden,1995,0,1,1,0,100,0,1,0,0,0,0,0
Sweden,1996,0,1,0,1,0,0,1,0,0,0,0,0
Sweden,1997,1,4,3,1,75,0,4,0,1,1,25,0.25
Sweden,1999,0,2,2,0,100,0,2,0,4,0,0,0
Sweden,2000,0,1,1,0,100,0,1,0,1,0,0,0
Sweden,2005,0,3,3,0,100,0,3,0,0,0,0,0
Sweden,2006,0,1,0,1,0,0,1,0,0,0,0,0
Sweden,2008,0,1,1,0,100,0,1,0,0,0,0,0
Sweden,2009,0,1,1,0,100,0,1,0,0,0,0,0
Sweden,2010,1,3,3,0,100,1,2,33.33333333,2,1,33.33333333,0.333333333
Sweden,2011,0,1,1,0,100,0,1,0,0,0,0,0
Sweden,2012,0,2,2,0,100,0,2,0,0,0,0,0
Sweden,2014,0,5,5,0,100,0,5,0,1,0,0,0
Sweden,2015,4,32,29,3,90.625,0,32,0,4,1,3.125,0.125
Sweden,2016,0,16,14,2,87.5,0,16,0,1,0,0,0
Sweden,2017,5,18,13,5,72.22222222,0,18,0,32,1,5.555555556,0.277777778
Switzerland,1970,47,3,3,0,100,0,3,0,0,1,33.33333333,15.66666667
Switzerland,1971,0,1,0,1,0,0,1,0,3,0,0,0
Switzerland,1972,0,3,0,3,0,0,3,0,0,0,0,0
Switzerland,1973,0,2,2,0,100,0,2,0,0,0,0,0
Switzerland,1974,0,3,3,0,100,0,3,0,0,0,0,0
Switzerland,1975,0,3,3,0,100,0,3,0,0,0,0,0
Switzerland,1976,0,4,4,0,100,0,4,0,0,0,0,0
Switzerland,1977,0,4,2,2,50,0,4,0,3,0,0,0
Switzerland,1978,0,3,3,0,100,0,3,0,0,0,0,0
Switzerland,1979,1,6,4,2,66.66666667,0,6,0,5,1,16.66666667,0.166666667
Switzerland,1980,0,7,3,4,42.85714286,0,7,0,3,0,0,0
Switzerland,1981,2,13,12,1,92.30769231,0,13,0,31,2,15.38461538,0.153846154
Switzerland,1982,0,6,6,0,100,0,6,0,0,0,0,0
Switzerland,1983,0,3,2,1,66.66666667,0,3,0,0,0,0,0
Switzerland,1984,0,1,1,0,100,0,1,0,0,0,0,0
Switzerland,1985,0,7,6,1,85.71428571,0,7,0,10,0,0,0
Switzerland,1987,1,1,1,0,100,0,1,0,0,1,100,1
Switzerland,1988,0,4,2,2,50,0,4,0,5,0,0,0
Switzerland,1990,1,1,1,0,100,0,1,0,0,1,100,1
Switzerland,1991,0,2,2,0,100,0,2,0,4,0,0,0
Switzerland,1992,6,6,4,2,66.66666667,0,6,0,6,2,33.33333333,1
Switzerland,1995,1,5,5,0,100,0,5,0,0,1,20,0.2
Switzerland,1996,1,4,4,0,100,0,4,0,3,1,25,0.25
Switzerland,1997,0,1,1,0,100,0,1,0,0,0,0,0
Switzerland,1998,0,1,1,0,100,0,1,0,0,0,0,0
Switzerland,1999,0,2,2,0,100,0,2,0,0,0,0,0
Switzerland,2000,0,4,4,0,100,0,4,0,0,0,0,0
Switzerland,2001,14,2,2,0,100,0,2,0,18,1,50,7
Switzerland,2003,0,1,1,0,100,0,1,0,0,0,0,0
Switzerland,2007,0,2,2,0,100,0,2,0,1,0,0,0
Switzerland,2011,0,3,2,1,66.66666667,0,3,0,2,0,0,0
Switzerland,2013,0,2,2,0,100,0,2,0,0,0,0,0
Switzerland,2016,0,1,0,1,0,0,1,0,0,0,0,0
Syria,1974,1,4,4,0,100,0,4,0,9,1,25,0.25
Syria,1975,0,2,2,0,100,0,2,0,0,0,0,0
Syria,1976,5,2,1,1,50,0,2,0,35,1,50,2.5
Syria,1977,1,3,3,0,100,0,3,0,0,1,33.33333333,0.333333333
Syria,1978,0,1,1,0,100,0,1,0,0,0,0,0
Syria,1979,80,28,27,1,96.42857143,0,28,0,31,19,67.85714286,2.857142857
Syria,1980,89,33,31,2,93.93939394,0,33,0,27,19,57.57575758,2.696969697
Syria,1981,192,41,40,1,97.56097561,0,41,0,223,26,63.41463415,4.682926829
Syria,1982,98,20,19,1,95,0,20,0,23,13,65,4.9
Syria,1983,1,1,1,0,100,0,1,0,0,1,100,1
Syria,1984,0,1,0,1,0,0,1,0,1,0,0,0
Syria,1985,30,1,1,0,100,0,1,0,30,1,100,30
Syria,1986,8,4,3,1,75,0,4,0,8,2,50,2
Syria,1989,0,1,0,1,0,0,1,0,0,0,0,0
Syria,1996,15,2,1,1,50,0,2,0,50,1,50,7.5
Syria,1997,2,1,1,0,100,0,1,0,0,1,100,2
Syria,1998,0,1,1,0,100,0,1,0,0,0,0,0
Syria,2004,4,1,1,0,100,0,1,0,2,1,100,4
Syria,2006,5,1,1,0,100,0,1,0,0,1,100,5
Syria,2008,18,1,1,0,100,1,0,100,14,1,100,18
Syria,2011,163,49,45,4,91.83673469,2,47,4.081632653,215,23,46.93877551,3.326530612
Syria,2012,877,180,176,4,97.77777778,37,143,20.55555556,1927,119,66.11111111,4.872222222
Syria,2013,1568,285,282,3,98.94736842,36,249,12.63157895,2237,170,59.64912281,5.501754386
Syria,2014,3312,331,326,5,98.48942598,53,278,16.01208459,2014,223,67.37160121,10.0060423
Syria,2015,3924,491,475,16,96.7413442,77,414,15.68228106,2978,311,63.3401222,7.99185336
Syria,2016,2810,473,453,20,95.77167019,79,394,16.70190275,2982,270,57.08245243,5.940803383
Syria,2017,2026,243,223,20,91.76954733,59,184,24.27983539,1303,150,61.72839506,8.33744856
Taiwan,1971,25,1,1,0,100,0,1,0,0,1,100,25
Taiwan,1976,0,1,0,1,0,0,1,0,1,0,0,0
Taiwan,1990,0,1,1,0,100,0,1,0,0,0,0,0
Taiwan,1991,7,2,2,0,100,0,2,0,28,2,100,3.5
Taiwan,1992,16,20,17,3,85,0,20,0,30,2,10,0.8
Taiwan,1994,1,5,4,1,80,0,5,0,3,1,20,0.2
Taiwan,1995,0,4,1,3,25,0,4,0,2,0,0,0
Taiwan,1996,9,5,5,0,100,0,5,0,1,2,40,1.8
Taiwan,1997,0,1,1,0,100,0,1,0,0,0,0,0
Taiwan,2001,2,2,2,0,100,0,2,0,18,1,50,1
Taiwan,2004,0,2,1,1,50,0,2,0,2,0,0,0
Taiwan,2008,0,1,0,1,0,0,1,0,1,0,0,0
Taiwan,2013,0,2,0,2,0,0,2,0,0,0,0,0
Taiwan,2014,0,1,0,1,0,0,1,0,0,0,0,0
Taiwan,2016,0,1,1,0,100,0,1,0,0,0,0,0
Taiwan,2017,0,1,1,0,100,0,1,0,1,0,0,0
Tajikistan,1992,14,17,16,1,94.11764706,0,17,0,804,6,35.29411765,0.823529412
Tajikistan,1994,48,31,30,1,96.77419355,0,31,0,63,21,67.74193548,1.548387097
Tajikistan,1995,78,34,31,3,91.17647059,0,34,0,23,28,82.35294118,2.294117647
Tajikistan,1996,50,22,21,1,95.45454545,0,22,0,34,14,63.63636364,2.272727273
Tajikistan,1997,43,40,38,2,95,0,40,0,44,20,50,1.075
Tajikistan,1998,29,11,11,0,100,0,11,0,3,5,45.45454545,2.636363636
Tajikistan,1999,2,4,4,0,100,0,4,0,6,2,50,0.5
Tajikistan,2000,11,6,6,0,100,0,6,0,77,5,83.33333333,1.833333333
Tajikistan,2001,8,6,6,0,100,0,6,0,11,4,66.66666667,1.333333333
Tajikistan,2005,0,1,1,0,100,0,1,0,0,0,0,0
Tajikistan,2007,1,1,1,0,100,0,1,0,0,1,100,1
Tajikistan,2009,0,1,1,0,100,0,1,0,1,0,0,0
Tajikistan,2010,4,1,1,0,100,1,0,100,25,1,100,4
Tajikistan,2012,3,5,5,0,100,0,5,0,6,3,60,0.6
Tajikistan,2014,1,1,1,0,100,0,1,0,2,1,100,1
Tajikistan,2015,12,3,3,0,100,0,3,0,10,3,100,4
Tajikistan,2016,2,2,2,0,100,0,2,0,0,2,100,1
Tajikistan,2017,1,2,2,0,100,0,2,0,0,1,50,0.5
Tanzania,1975,0,1,1,0,100,0,1,0,0,0,0,0
Tanzania,1979,1,1,1,0,100,0,1,0,0,1,100,1
Tanzania,1982,0,1,1,0,100,0,1,0,1,0,0,0
Tanzania,1994,1,1,1,0,100,0,1,0,0,1,100,1
Tanzania,1995,0,1,1,0,100,0,1,0,0,0,0,0
Tanzania,1997,1,1,1,0,100,0,1,0,0,1,100,1
Tanzania,1998,11,1,1,0,100,1,0,100,85,1,100,11
Tanzania,2000,0,2,1,1,50,0,2,0,0,0,0,0
Tanzania,2001,2,4,3,1,75,0,4,0,0,2,50,0.5
Tanzania,2002,24,2,2,0,100,0,2,0,0,2,100,12
Tanzania,2004,0,1,0,1,0,0,1,0,0,0,0,0
Tanzania,2008,0,1,1,0,100,0,1,0,2,0,0,0
Tanzania,2010,0,1,0,1,0,0,1,0,0,0,0,0
Tanzania,2013,8,7,7,0,100,0,7,0,83,3,42.85714286,1.142857143
Tanzania,2014,4,11,10,1,90.90909091,0,11,0,43,2,18.18181818,0.363636364
Tanzania,2015,10,14,13,1,92.85714286,0,14,0,14,4,28.57142857,0.714285714
Tanzania,2016,3,3,2,1,66.66666667,0,3,0,2,1,33.33333333,1
Tanzania,2017,8,6,4,2,66.66666667,0,6,0,4,1,16.66666667,1.333333333
Thailand,1972,0,1,1,0,100,0,1,0,0,0,0,0
Thailand,1974,2,1,1,0,100,0,1,0,0,1,100,2
Thailand,1977,1,3,2,1,66.66666667,0,3,0,70,1,33.33333333,0.333333333
Thailand,1978,29,5,5,0,100,0,5,0,25,3,60,5.8
Thailand,1979,62,16,15,1,93.75,0,16,0,49,11,68.75,3.875
Thailand,1980,75,26,23,3,88.46153846,0,26,0,171,15,57.69230769,2.884615385
Thailand,1981,21,18,18,0,100,0,18,0,62,4,22.22222222,1.166666667
Thailand,1982,1,3,3,0,100,0,3,0,20,1,33.33333333,0.333333333
Thailand,1983,0,1,1,0,100,0,1,0,0,0,0,0
Thailand,1984,0,1,1,0,100,0,1,0,20,0,0,0
Thailand,1985,0,1,1,0,100,0,1,0,0,0,0,0
Thailand,1986,0,3,2,1,66.66666667,0,3,0,3,0,0,0
Thailand,1988,10,5,3,2,60,0,5,0,2,2,40,2
Thailand,1989,35,16,16,0,100,0,16,0,51,9,56.25,2.1875
Thailand,1990,22,10,9,1,90,0,10,0,54,5,50,2.2
Thailand,1991,11,8,8,0,100,0,8,0,27,3,37.5,1.375
Thailand,1992,39,25,22,3,88,0,25,0,90,12,48,1.56
Thailand,1994,17,24,22,2,91.66666667,0,24,0,47,10,41.66666667,0.708333333
Thailand,1995,19,12,9,3,75,0,12,0,25,8,66.66666667,1.583333333
Thailand,1996,10,19,17,2,89.47368421,0,19,0,16,8,42.10526316,0.526315789
Thailand,1997,18,20,18,2,90,0,20,0,24,10,50,0.9
Thailand,1998,4,4,3,1,75,0,4,0,42,1,25,1
Thailand,1999,0,4,4,0,100,0,4,0,0,0,0,0
Thailand,2000,7,4,4,0,100,0,4,0,4,2,50,1.75
Thailand,2001,11,14,12,2,85.71428571,0,14,0,59,9,64.28571429,0.785714286
Thailand,2002,16,12,12,0,100,0,12,0,45,5,41.66666667,1.333333333
Thailand,2003,6,6,5,1,83.33333333,0,6,0,6,3,50,1
Thailand,2004,32,44,42,2,95.45454545,0,44,0,150,24,54.54545455,0.727272727
Thailand,2005,130,155,148,7,95.48387097,0,155,0,348,98,63.22580645,0.838709677
Thailand,2006,194,202,201,1,99.5049505,0,202,0,413,134,66.33663366,0.96039604
Thailand,2007,264,293,282,11,96.24573379,0,293,0,647,148,50.51194539,0.901023891
Thailand,2008,166,200,193,7,96.5,0,200,0,636,112,56,0.83
Thailand,2009,270,298,288,10,96.6442953,0,298,0,460,206,69.12751678,0.906040268
Thailand,2010,154,253,244,9,96.44268775,0,253,0,313,109,43.08300395,0.608695652
Thailand,2011,152,182,177,5,97.25274725,0,182,0,435,96,52.74725275,0.835164835
Thailand,2012,209,279,261,18,93.5483871,0,279,0,1055,117,41.93548387,0.749103943
Thailand,2013,255,472,439,33,93.00847458,0,472,0,680,141,29.87288136,0.540254237
Thailand,2014,192,423,392,31,92.6713948,0,423,0,651,128,30.26004728,0.453900709
Thailand,2015,116,278,252,26,90.64748201,0,278,0,463,68,24.46043165,0.417266187
Thailand,2016,120,329,304,25,92.40121581,0,329,0,385,88,26.74772036,0.364741641
Thailand,2017,72,179,166,13,92.73743017,0,179,0,270,45,25.1396648,0.402234637
Togo,1985,1,3,2,1,66.66666667,0,3,0,2,1,33.33333333,0.333333333
Togo,1991,13,2,1,1,50,0,2,0,0,1,50,6.5
Togo,1992,12,27,24,3,88.88888889,0,27,0,23,7,25.92592593,0.444444444
Togo,1994,47,13,12,1,92.30769231,0,13,0,9,7,53.84615385,3.615384615
Togo,1995,0,1,1,0,100,0,1,0,0,0,0,0
Togo,1996,3,1,1,0,100,0,1,0,0,1,100,3
Togo,2005,0,1,1,0,100,0,1,0,0,0,0,0
Trinidad and Tobago,1976,0,1,1,0,100,0,1,0,3,0,0,0
Trinidad and Tobago,1979,0,1,1,0,100,0,1,0,0,0,0,0
Trinidad and Tobago,1981,0,1,1,0,100,0,1,0,0,0,0,0
Trinidad and Tobago,1983,0,1,1,0,100,0,1,0,14,0,0,0
Trinidad and Tobago,1989,0,1,1,0,100,0,1,0,0,0,0,0
Trinidad and Tobago,1991,0,1,0,1,0,0,1,0,1,0,0,0
Trinidad and Tobago,1992,0,1,1,0,100,0,1,0,0,0,0,0
Trinidad and Tobago,1994,2,1,1,0,100,0,1,0,0,1,100,2
Trinidad and Tobago,1995,4,4,4,0,100,0,4,0,0,4,100,1
Trinidad and Tobago,1996,0,3,3,0,100,0,3,0,3,0,0,0
Trinidad and Tobago,2005,0,2,2,0,100,0,2,0,14,0,0,0
Trinidad and Tobago,2010,0,1,1,0,100,0,1,0,0,0,0,0
Trinidad and Tobago,2013,0,3,3,0,100,0,3,0,0,0,0,0
Trinidad and Tobago,2015,0,1,0,1,0,0,1,0,0,0,0,0
Tunisia,1979,0,1,1,0,100,0,1,0,0,0,0,0
Tunisia,1980,41,1,1,0,100,0,1,0,100,1,100,41
Tunisia,1986,0,2,2,0,100,0,2,0,0,0,0,0
Tunisia,1987,0,4,4,0,100,0,4,0,13,0,0,0
Tunisia,1991,4,2,2,0,100,0,2,0,0,2,100,2
Tunisia,1994,1,1,1,0,100,0,1,0,0,1,100,1
Tunisia,1995,7,1,1,0,100,0,1,0,0,1,100,7
Tunisia,2000,5,1,1,0,100,0,1,0,0,1,100,5
Tunisia,2001,3,1,1,0,100,0,1,0,0,1,100,3
Tunisia,2002,21,1,1,0,100,1,0,100,30,1,100,21
Tunisia,2007,14,1,0,1,0,0,1,0,0,1,100,14
Tunisia,2008,0,2,2,0,100,0,2,0,0,0,0,0
Tunisia,2011,4,3,2,1,66.66666667,1,2,33.33333333,0,1,33.33333333,1.333333333
Tunisia,2012,4,3,3,0,100,0,3,0,46,1,33.33333333,1.333333333
Tunisia,2013,25,29,25,4,86.20689655,4,25,13.79310345,28,9,31.03448276,0.862068966
Tunisia,2014,43,23,21,2,91.30434783,0,23,0,64,14,60.86956522,1.869565217
Tunisia,2015,103,17,15,2,88.23529412,1,16,5.882352941,121,14,82.35294118,6.058823529
Tunisia,2016,71,12,10,2,83.33333333,1,11,8.333333333,26,9,75,5.916666667
Tunisia,2017,5,4,4,0,100,0,4,0,5,3,75,1.25
Turkey,1970,0,12,9,3,75,0,12,0,1,0,0,0
Turkey,1971,1,35,31,4,88.57142857,0,35,0,0,1,2.857142857,0.028571429
Turkey,1972,3,9,7,2,77.77777778,0,9,0,5,1,11.11111111,0.333333333
Turkey,1974,0,1,0,1,0,0,1,0,1,0,0,0
Turkey,1975,0,10,10,0,100,0,10,0,0,0,0,0
Turkey,1976,7,35,34,1,97.14285714,0,35,0,23,3,8.571428571,0.2
Turkey,1977,29,189,180,9,95.23809524,0,189,0,89,21,11.11111111,0.153439153
Turkey,1978,40,52,49,3,94.23076923,0,52,0,111,17,32.69230769,0.769230769
Turkey,1979,123,141,122,19,86.5248227,0,141,0,118,72,51.06382979,0.872340426
Turkey,1980,111,95,90,5,94.73684211,0,95,0,61,67,70.52631579,1.168421053
Turkey,1981,11,8,6,2,75,0,8,0,11,5,62.5,1.375
Turkey,1982,9,5,5,0,100,0,5,0,71,1,20,1.8
Turkey,1983,2,5,4,1,80,0,5,0,24,1,20,0.4
Turkey,1984,27,19,11,8,57.89473684,0,19,0,19,7,36.84210526,1.421052632
Turkey,1985,1,2,2,0,100,0,2,0,0,1,50,0.5
Turkey,1986,26,7,7,0,100,0,7,0,7,6,85.71428571,3.714285714
Turkey,1987,187,43,42,1,97.6744186,0,43,0,80,30,69.76744186,4.348837209
Turkey,1988,102,42,39,3,92.85714286,0,42,0,21,22,52.38095238,2.428571429
Turkey,1989,232,114,111,3,97.36842105,0,114,0,53,63,55.26315789,2.035087719
Turkey,1990,512,195,191,4,97.94871795,0,195,0,219,133,68.20512821,2.625641026
Turkey,1991,308,293,281,12,95.90443686,0,293,0,300,108,36.86006826,1.051194539
Turkey,1992,1233,514,479,35,93.19066148,0,514,0,537,318,61.86770428,2.398832685
Turkey,1994,982,300,280,20,93.33333333,0,300,0,452,152,50.66666667,3.273333333
Turkey,1995,189,133,126,7,94.73684211,0,133,0,216,53,39.84962406,1.421052632
Turkey,1996,117,54,52,2,96.2962963,3,51,5.555555556,92,31,57.40740741,2.166666667
Turkey,1997,60,44,39,5,88.63636364,0,44,0,108,18,40.90909091,1.363636364
Turkey,1998,37,23,22,1,95.65217391,3,20,13.04347826,108,12,52.17391304,1.608695652
Turkey,1999,127,109,98,11,89.90825688,11,98,10.09174312,271,48,44.03669725,1.165137615
Turkey,2000,12,35,30,5,85.71428571,1,34,2.857142857,27,9,25.71428571,0.342857143
Turkey,2001,17,19,16,3,84.21052632,2,17,10.52631579,40,6,31.57894737,0.894736842
Turkey,2002,0,5,4,1,80,0,5,0,0,0,0,0
Turkey,2003,67,19,18,1,94.73684211,5,14,26.31578947,778,9,47.36842105,3.526315789
Turkey,2004,25,27,25,2,92.59259259,1,26,3.703703704,92,11,40.74074074,0.925925926
Turkey,2005,35,41,39,2,95.12195122,1,40,2.43902439,140,16,39.02439024,0.853658537
Turkey,2006,46,43,42,1,97.6744186,2,41,4.651162791,316,15,34.88372093,1.069767442
Turkey,2007,25,29,27,2,93.10344828,0,29,0,122,7,24.13793103,0.862068966
Turkey,2008,42,32,30,2,93.75,1,31,3.125,274,10,31.25,1.3125
Turkey,2009,18,13,12,1,92.30769231,1,12,7.692307692,48,5,38.46153846,1.384615385
Turkey,2010,13,20,18,2,90,0,20,0,7,4,20,0.65
Turkey,2011,25,51,47,4,92.15686275,2,49,3.921568627,110,10,19.60784314,0.490196078
Turkey,2012,247,188,170,18,90.42553191,3,185,1.595744681,463,72,38.29787234,1.313829787
Turkey,2013,83,42,37,5,88.0952381,1,41,2.380952381,192,7,16.66666667,1.976190476
Turkey,2014,39,94,84,10,89.36170213,1,93,1.063829787,89,21,22.34042553,0.414893617
Turkey,2015,490,422,358,64,84.83412322,5,417,1.184834123,1103,171,40.52132701,1.161137441
Turkey,2016,1006,542,481,61,88.74538745,24,518,4.42804428,2772,289,53.32103321,1.856088561
Turkey,2017,222,181,144,37,79.55801105,9,172,4.972375691,328,100,55.24861878,1.226519337
Turkmenistan,2002,0,1,0,1,0,0,1,0,1,0,0,0
Turkmenistan,2014,3,1,1,0,100,0,1,0,2,1,100,3
USSR,1989,6,7,5,2,71.42857143,0,7,0,27,2,28.57142857,0.857142857
USSR,1990,58,36,31,5,86.11111111,0,36,0,101,16,44.44444444,1.611111111
USSR,1991,28,34,30,4,88.23529412,0,34,0,22,6,17.64705882,0.823529412
Uganda,1979,13,8,8,0,100,0,8,0,3,3,37.5,1.625
Uganda,1981,57,25,22,3,88,0,25,0,9,11,44,2.28
Uganda,1982,0,1,1,0,100,0,1,0,0,0,0,0
Uganda,1983,121,6,6,0,100,0,6,0,2,6,100,20.16666667
Uganda,1984,235,3,3,0,100,0,3,0,0,2,66.66666667,78.33333333
Uganda,1985,32,7,5,2,71.42857143,0,7,0,8,3,42.85714286,4.571428571
Uganda,1986,1,1,1,0,100,0,1,0,0,1,100,1
Uganda,1987,1,1,1,0,100,0,1,0,4,1,100,1
Uganda,1988,160,15,14,1,93.33333333,0,15,0,22,15,100,10.66666667
Uganda,1989,72,15,15,0,100,0,15,0,37,11,73.33333333,4.8
Uganda,1990,84,14,13,1,92.85714286,0,14,0,31,12,85.71428571,6
Uganda,1991,2,2,2,0,100,0,2,0,0,1,50,1
Uganda,1992,2,3,1,2,33.33333333,0,3,0,14,1,33.33333333,0.666666667
Uganda,1994,22,13,12,1,92.30769231,0,13,0,41,10,76.92307692,1.692307692
Uganda,1995,145,7,7,0,100,0,7,0,20,6,85.71428571,20.71428571
Uganda,1996,413,29,29,0,100,0,29,0,110,22,75.86206897,14.24137931
Uganda,1997,239,24,24,0,100,0,24,0,121,20,83.33333333,9.958333333
Uganda,1998,81,18,18,0,100,0,18,0,72,13,72.22222222,4.5
Uganda,1999,75,19,19,0,100,0,19,0,91,18,94.73684211,3.947368421
Uganda,2000,297,20,19,1,95,0,20,0,90,15,75,14.85
Uganda,2001,56,24,24,0,100,0,24,0,83,13,54.16666667,2.333333333
Uganda,2002,173,24,23,1,95.83333333,0,24,0,44,12,50,7.208333333
Uganda,2003,231,30,30,0,100,0,30,0,72,23,76.66666667,7.7
Uganda,2004,193,10,10,0,100,0,10,0,107,10,100,19.3
Uganda,2005,80,11,11,0,100,0,11,0,43,10,90.90909091,7.272727273
Uganda,2007,2,1,1,0,100,0,1,0,1,1,100,2
Uganda,2008,3,7,7,0,100,0,7,0,11,3,42.85714286,0.428571429
Uganda,2009,11,2,1,1,50,0,2,0,0,1,50,5.5
Uganda,2010,75,6,4,2,66.66666667,2,4,33.33333333,71,2,33.33333333,12.5
Uganda,2012,5,4,4,0,100,0,4,0,0,4,100,1.25
Uganda,2014,98,6,5,1,83.33333333,0,6,0,16,5,83.33333333,16.33333333
Uganda,2015,4,10,7,3,70,0,10,0,1,4,40,0.4
Uganda,2016,75,15,11,4,73.33333333,0,15,0,19,10,66.66666667,5
Uganda,2017,7,13,5,8,38.46153846,0,13,0,2,4,30.76923077,0.538461538
Ukraine,1991,0,2,0,2,0,0,2,0,1,0,0,0
Ukraine,1992,1,1,1,0,100,0,1,0,1,1,100,1
Ukraine,1994,4,10,5,5,50,0,10,0,6,3,30,0.4
Ukraine,1995,0,2,1,1,50,0,2,0,2,0,0,0
Ukraine,1996,0,3,2,1,66.66666667,0,3,0,3,0,0,0
Ukraine,1997,2,2,2,0,100,0,2,0,0,2,100,1
Ukraine,1999,1,6,3,3,50,0,6,0,37,1,16.66666667,0.166666667
Ukraine,2000,0,1,1,0,100,0,1,0,0,0,0,0
Ukraine,2002,1,3,3,0,100,0,3,0,2,1,33.33333333,0.333333333
Ukraine,2003,0,1,1,0,100,0,1,0,1,0,0,0
Ukraine,2007,0,1,0,1,0,0,1,0,0,0,0,0
Ukraine,2008,0,1,1,0,100,0,1,0,2,0,0,0
Ukraine,2009,0,2,2,0,100,0,2,0,8,0,0,0
Ukraine,2010,1,4,4,0,100,0,4,0,8,1,25,0.25
Ukraine,2011,0,3,3,0,100,0,3,0,0,0,0,0
Ukraine,2012,1,8,7,1,87.5,0,8,0,36,1,12.5,0.125
Ukraine,2013,1,5,5,0,100,1,4,20,3,1,20,0.2
Ukraine,2014,1396,895,801,94,89.4972067,1,894,0.111731844,1226,217,24.24581006,1.559776536
Ukraine,2015,765,637,586,51,91.99372057,0,637,0,1401,144,22.60596546,1.200941915
Ukraine,2016,48,61,49,12,80.32786885,0,61,0,40,12,19.67213115,0.786885246
Ukraine,2017,40,61,52,9,85.24590164,1,60,1.639344262,64,16,26.2295082,0.655737705
United Arab Emirates,1974,1,1,1,0,100,0,1,0,2,1,100,1
United Arab Emirates,1977,1,1,1,0,100,0,1,0,0,1,100,1
United Arab Emirates,1978,5,1,1,0,100,0,1,0,0,1,100,5
United Arab Emirates,1979,0,2,2,0,100,0,2,0,0,0,0,0
United Arab Emirates,1980,1,1,1,0,100,0,1,0,15,1,100,1
United Arab Emirates,1981,2,3,3,0,100,0,3,0,7,1,33.33333333,0.666666667
United Arab Emirates,1983,111,1,1,0,100,0,1,0,0,1,100,111
United Arab Emirates,1985,0,2,1,1,50,0,2,0,1,0,0,0
United Arab Emirates,1986,0,1,1,0,100,0,1,0,0,0,0,0
United Arab Emirates,1989,1,1,1,0,100,0,1,0,0,1,100,1
United Arab Emirates,1992,0,1,0,1,0,0,1,0,1,0,0,0
United Arab Emirates,1995,0,2,1,1,50,0,2,0,0,0,0,0
United Arab Emirates,2010,0,2,1,1,50,1,1,50,1,0,0,0
United Arab Emirates,2013,0,1,1,0,100,0,1,0,0,0,0,0
United Arab Emirates,2014,1,2,1,1,50,0,2,0,0,1,50,0.5
United Kingdom,1970,20,12,10,2,83.33333333,0,12,0,1,10,83.33333333,1.666666667
United Kingdom,1971,110,81,75,6,92.59259259,0,81,0,1,79,97.5308642,1.358024691
United Kingdom,1972,368,292,276,16,94.52054795,0,292,0,224,282,96.57534247,1.260273973
United Kingdom,1973,210,189,178,11,94.17989418,0,189,0,275,179,94.70899471,1.111111111
United Kingdom,1974,235,203,193,10,95.07389163,0,203,0,329,173,85.22167488,1.157635468
United Kingdom,1975,245,194,188,6,96.90721649,0,194,0,129,178,91.75257732,1.262886598
United Kingdom,1976,264,194,188,6,96.90721649,0,194,0,19,191,98.45360825,1.360824742
United Kingdom,1977,103,140,134,6,95.71428571,0,140,0,17,93,66.42857143,0.735714286
United Kingdom,1978,81,100,91,9,91,0,100,0,113,56,56,0.81
United Kingdom,1979,133,239,217,22,90.79497908,0,239,0,150,88,36.82008368,0.556485356
United Kingdom,1980,78,134,118,16,88.05970149,0,134,0,92,71,52.98507463,0.582089552
United Kingdom,1981,86,142,113,29,79.57746479,0,142,0,118,77,54.22535211,0.605633803
United Kingdom,1982,95,95,85,10,89.47368421,0,95,0,152,61,64.21052632,1
United Kingdom,1983,77,177,143,34,80.79096045,0,177,0,186,62,35.02824859,0.435028249
United Kingdom,1984,69,145,121,24,83.44827586,0,145,0,249,55,37.93103448,0.475862069
United Kingdom,1985,64,67,58,9,86.56716418,0,67,0,175,38,56.71641791,0.955223881
United Kingdom,1986,63,95,80,15,84.21052632,0,95,0,80,54,56.84210526,0.663157895
United Kingdom,1987,104,117,89,28,76.06837607,0,117,0,120,74,63.24786325,0.888888889
United Kingdom,1988,372,181,137,44,75.69060773,0,181,0,263,70,38.67403315,2.055248619
United Kingdom,1989,66,163,114,49,69.93865031,0,163,0,174,47,28.83435583,0.404907975
United Kingdom,1990,76,147,101,46,68.70748299,0,147,0,123,58,39.45578231,0.517006803
United Kingdom,1991,88,262,197,65,75.19083969,0,262,0,235,70,26.71755725,0.335877863
United Kingdom,1992,94,274,223,51,81.38686131,0,274,0,453,73,26.64233577,0.343065693
United Kingdom,1994,66,256,193,63,75.390625,0,256,0,177,54,21.09375,0.2578125
United Kingdom,1995,11,22,17,5,77.27272727,0,22,0,5,11,50,0.5
United Kingdom,1996,14,36,25,11,69.44444444,0,36,0,395,13,36.11111111,0.388888889
United Kingdom,1997,23,78,50,28,64.1025641,0,78,0,35,22,28.20512821,0.294871795
United Kingdom,1998,46,63,49,14,77.77777778,0,63,0,259,15,23.80952381,0.73015873
United Kingdom,1999,7,76,54,22,71.05263158,0,76,0,161,6,7.894736842,0.092105263
United Kingdom,2000,7,61,50,11,81.96721311,0,61,0,28,6,9.836065574,0.114754098
United Kingdom,2001,8,94,64,30,68.08510638,0,94,0,33,7,7.446808511,0.085106383
United Kingdom,2002,2,21,15,6,71.42857143,0,21,0,13,2,9.523809524,0.095238095
United Kingdom,2003,2,23,16,7,69.56521739,0,23,0,11,1,4.347826087,0.086956522
United Kingdom,2004,0,5,4,1,80,0,5,0,2,0,0,0
United Kingdom,2005,57,29,24,5,82.75862069,4,25,13.79310345,837,5,17.24137931,1.965517241
United Kingdom,2006,0,6,3,3,50,0,6,0,0,0,0,0
United Kingdom,2007,4,20,15,5,75,1,19,5,13,3,15,0.2
United Kingdom,2008,0,39,32,7,82.05128205,0,39,0,8,0,0,0
United Kingdom,2009,3,23,19,4,82.60869565,0,23,0,12,2,8.695652174,0.130434783
United Kingdom,2010,0,57,37,20,64.9122807,0,57,0,22,0,0,0
United Kingdom,2011,1,47,24,23,51.06382979,0,47,0,3,1,2.127659574,0.021276596
United Kingdom,2012,2,55,25,30,45.45454545,0,55,0,2,2,3.636363636,0.036363636
United Kingdom,2013,4,137,68,69,49.6350365,0,137,0,64,4,2.919708029,0.02919708
United Kingdom,2014,0,103,64,39,62.13592233,0,103,0,4,0,0,0
United Kingdom,2015,1,114,65,49,57.01754386,0,114,0,23,1,0.877192982,0.00877193
United Kingdom,2016,9,105,71,34,67.61904762,0,105,0,20,9,8.571428571,0.085714286
United Kingdom,2017,42,122,93,29,76.2295082,2,120,1.639344262,301,5,4.098360656,0.344262295
United States,1970,33,468,385,83,82.26495726,0,468,0,160,27,5.769230769,0.070512821
United States,1971,20,247,214,33,86.63967611,0,247,0,55,16,6.477732794,0.08097166
United States,1972,10,68,48,20,70.58823529,0,68,0,35,7,10.29411765,0.147058824
United States,1973,45,58,50,8,86.20689655,0,58,0,33,25,43.10344828,0.775862069
United States,1974,16,94,85,9,90.42553191,0,94,0,54,11,11.70212766,0.170212766
United States,1975,24,149,136,13,91.27516779,0,149,0,158,9,6.040268456,0.161073826
United States,1976,4,105,88,17,83.80952381,0,105,0,41,4,3.80952381,0.038095238
United States,1977,4,130,95,35,73.07692308,0,130,0,17,4,3.076923077,0.030769231
United States,1978,8,87,75,12,86.20689655,0,87,0,8,7,8.045977011,0.091954023
United States,1979,18,69,54,15,78.26086957,0,69,0,58,11,15.94202899,0.260869565
United States,1980,15,67,57,10,85.07462687,0,67,0,22,12,17.91044776,0.223880597
United States,1981,8,74,55,19,74.32432432,0,74,0,15,8,10.81081081,0.108108108
United States,1982,11,78,67,11,85.8974359,0,78,0,37,11,14.1025641,0.141025641
United States,1983,8,44,40,4,90.90909091,0,44,0,5,6,13.63636364,0.181818182
United States,1984,3,63,58,5,92.06349206,0,63,0,780,3,4.761904762,0.047619048
United States,1985,3,40,25,15,62.5,0,40,0,13,3,7.5,0.075
United States,1986,1,49,31,18,63.26530612,0,49,0,36,1,2.040816327,0.020408163
United States,1987,1,34,29,5,85.29411765,0,34,0,1,1,2.941176471,0.029411765
United States,1988,1,27,22,5,81.48148148,0,27,0,1,1,3.703703704,0.037037037
United States,1989,3,42,33,9,78.57142857,0,42,0,14,3,7.142857143,0.071428571
United States,1990,5,32,32,0,100,0,32,0,7,4,12.5,0.15625
United States,1991,2,30,29,1,96.66666667,0,30,0,4,2,6.666666667,0.066666667
United States,1992,2,32,26,6,81.25,0,32,0,3,2,6.25,0.0625
United States,1994,10,55,42,13,76.36363636,0,55,0,16,9,16.36363636,0.181818182
United States,1995,178,60,52,8,86.66666667,1,59,1.666666667,738,4,6.666666667,2.966666667
United States,1996,2,35,29,6,82.85714286,0,35,0,119,2,5.714285714,0.057142857
United States,1997,2,40,27,13,67.5,0,40,0,18,2,5,0.05
United States,1998,4,31,23,8,74.19354839,0,31,0,3,3,9.677419355,0.129032258
United States,1999,20,53,35,18,66.03773585,1,52,1.886792453,40,4,7.547169811,0.377358491
United States,2000,0,32,27,5,84.375,0,32,0,7,0,0,0
United States,2001,3008,41,33,8,80.48780488,4,37,9.756097561,16515,9,21.95121951,73.36585366
United States,2002,4,33,21,12,63.63636364,1,32,3.03030303,11,2,6.060606061,0.121212121
United States,2003,0,33,27,6,81.81818182,0,33,0,0,0,0,0
United States,2004,0,9,7,2,77.77777778,0,9,0,0,0,0,0
United States,2005,0,21,16,5,76.19047619,0,21,0,0,0,0,0
United States,2006,1,6,4,2,66.66666667,0,6,0,14,1,16.66666667,0.166666667
United States,2007,0,8,5,3,62.5,0,8,0,0,0,0,0
United States,2008,2,18,17,1,94.44444444,0,18,0,13,1,5.555555556,0.111111111
United States,2009,18,11,10,1,90.90909091,1,10,9.090909091,41,5,45.45454545,1.636363636
United States,2010,4,17,14,3,82.35294118,2,15,11.76470588,17,3,17.64705882,0.235294118
United States,2011,0,10,6,4,60,0,10,0,2,0,0,0
United States,2012,7,20,20,0,100,0,20,0,7,1,5,0.35
United States,2013,23,20,13,7,65,0,20,0,436,7,35,1.15
United States,2014,26,29,26,3,89.65517241,1,28,3.448275862,19,14,48.27586207,0.896551724
United States,2015,54,38,35,3,92.10526316,1,37,2.631578947,58,10,26.31578947,1.421052632
United States,2016,68,64,57,7,89.0625,0,64,0,139,9,14.0625,1.0625
United States,2017,95,65,60,5,92.30769231,2,63,3.076923077,932,19,29.23076923,1.461538462
Uruguay,1970,3,33,31,2,93.93939394,0,33,0,0,2,6.060606061,0.090909091
Uruguay,1971,1,8,8,0,100,0,8,0,0,1,12.5,0.125
Uruguay,1972,0,7,1,6,14.28571429,0,7,0,0,0,0,0
Uruguay,1984,0,4,4,0,100,0,4,0,0,0,0,0
Uruguay,1985,0,2,2,0,100,0,2,0,0,0,0,0
Uruguay,1986,0,2,2,0,100,0,2,0,0,0,0,0
Uruguay,1989,1,1,1,0,100,0,1,0,0,1,100,1
Uruguay,1990,0,1,1,0,100,0,1,0,0,0,0,0
Uruguay,1991,0,3,3,0,100,0,3,0,0,0,0,0
Uruguay,1992,0,11,9,2,81.81818182,0,11,0,0,0,0,0
Uruguay,1994,0,4,4,0,100,0,4,0,4,0,0,0
Uruguay,1995,0,1,1,0,100,0,1,0,0,0,0,0
Uruguay,1996,0,1,0,1,0,0,1,0,0,0,0,0
Uruguay,1997,0,2,2,0,100,0,2,0,1,0,0,0
Uruguay,2005,0,1,1,0,100,0,1,0,0,0,0,0
Uruguay,2016,1,1,1,0,100,0,1,0,1,1,100,1
Uzbekistan,1992,0,2,2,0,100,0,2,0,1,0,0,0
Uzbekistan,1995,0,1,1,0,100,0,1,0,0,0,0,0
Uzbekistan,1999,19,8,8,0,100,0,8,0,128,7,87.5,2.375
Uzbekistan,2004,36,5,5,0,100,5,0,100,31,5,100,7.2
Uzbekistan,2005,10,2,1,1,50,0,2,0,34,2,100,5
Uzbekistan,2009,3,2,2,0,100,1,1,50,6,2,100,1.5
Uzbekistan,2015,0,1,0,1,0,0,1,0,0,0,0,0
Vanuatu,1996,0,2,2,0,100,0,2,0,0,0,0,0
Vatican City,1981,0,1,0,1,0,0,1,0,3,0,0,0
Venezuela,1970,0,2,2,0,100,0,2,0,0,0,0,0
Venezuela,1971,0,4,4,0,100,0,4,0,0,0,0,0
Venezuela,1972,0,1,1,0,100,0,1,0,0,0,0,0
Venezuela,1973,0,4,4,0,100,0,4,0,0,0,0,0
Venezuela,1974,0,3,3,0,100,0,3,0,0,0,0,0
Venezuela,1975,0,5,4,1,80,0,5,0,0,0,0,0
Venezuela,1976,0,4,4,0,100,0,4,0,0,0,0,0
Venezuela,1977,1,3,3,0,100,0,3,0,0,1,33.33333333,0.333333333
Venezuela,1978,1,7,6,1,85.71428571,0,7,0,5,1,14.28571429,0.142857143
Venezuela,1979,0,4,3,1,75,0,4,0,0,0,0,0
Venezuela,1980,3,8,8,0,100,0,8,0,13,2,25,0.375
Venezuela,1981,2,7,7,0,100,0,7,0,0,1,14.28571429,0.285714286
Venezuela,1982,30,2,2,0,100,0,2,0,0,2,100,15
Venezuela,1983,7,6,6,0,100,0,6,0,0,4,66.66666667,1.166666667
Venezuela,1984,2,4,4,0,100,0,4,0,0,1,25,0.5
Venezuela,1985,0,2,2,0,100,0,2,0,0,0,0,0
Venezuela,1986,13,8,6,2,75,0,8,0,12,3,37.5,1.625
Venezuela,1987,3,13,13,0,100,0,13,0,0,2,15.38461538,0.230769231
Venezuela,1988,41,10,9,1,90,0,10,0,5,6,60,4.1
Venezuela,1989,14,8,7,1,87.5,0,8,0,0,3,37.5,1.75
Venezuela,1990,0,1,1,0,100,0,1,0,0,0,0,0
Venezuela,1991,47,17,15,2,88.23529412,0,17,0,1,4,23.52941176,2.764705882
Venezuela,1992,7,32,27,5,84.375,0,32,0,28,3,9.375,0.21875
Venezuela,1994,4,12,10,2,83.33333333,0,12,0,10,2,16.66666667,0.333333333
Venezuela,1995,8,11,6,5,54.54545455,0,11,0,34,1,9.090909091,0.727272727
Venezuela,1996,13,12,10,2,83.33333333,0,12,0,4,7,58.33333333,1.083333333
Venezuela,1997,3,41,30,11,73.17073171,0,41,0,1,2,4.87804878,0.073170732
Venezuela,1998,0,1,1,0,100,0,1,0,1,0,0,0
Venezuela,1999,0,5,3,2,60,0,5,0,0,0,0,0
Venezuela,2001,0,5,2,3,40,0,5,0,1,0,0,0
Venezuela,2002,0,5,2,3,40,0,5,0,0,0,0,0
Venezuela,2003,0,8,8,0,100,0,8,0,4,0,0,0
Venezuela,2007,1,2,2,0,100,0,2,0,8,1,50,0.5
Venezuela,2008,1,1,1,0,100,0,1,0,0,1,100,1
Venezuela,2009,10,3,3,0,100,0,3,0,1,1,33.33333333,3.333333333
Venezuela,2012,0,1,0,1,0,0,1,0,2,0,0,0
Venezuela,2013,0,1,1,0,100,0,1,0,7,0,0,0
Venezuela,2014,1,4,4,0,100,0,4,0,1,1,25,0.25
Venezuela,2015,1,3,3,0,100,0,3,0,0,1,33.33333333,0.333333333
Venezuela,2016,9,6,6,0,100,0,6,0,77,4,66.66666667,1.5
Venezuela,2017,5,17,13,4,76.47058824,0,17,0,32,4,23.52941176,0.294117647
Vietnam,1992,0,1,1,0,100,0,1,0,0,0,0,0
Vietnam,1994,0,1,1,0,100,0,1,0,21,0,0,0
Vietnam,1995,0,1,1,0,100,0,1,0,5,0,0,0
Vietnam,1996,0,1,1,0,100,0,1,0,1,0,0,0
Vietnam,1997,1,2,2,0,100,0,2,0,0,1,50,0.5
Vietnam,2001,0,4,0,4,0,0,4,0,0,0,0,0
Vietnam,2017,0,2,1,1,50,0,2,0,0,0,0,0
Wallis and Futuna,1994,0,1,1,0,100,0,1,0,0,0,0,0
West Germany (FRG),1970,8,20,19,1,95,0,20,0,9,2,10,0.4
West Germany (FRG),1971,0,13,12,1,92.30769231,0,13,0,0,0,0,0
West Germany (FRG),1972,23,24,20,4,83.33333333,0,24,0,45,6,25,0.958333333
West Germany (FRG),1973,1,27,25,2,92.59259259,0,27,0,1,1,3.703703704,0.037037037
West Germany (FRG),1974,1,28,26,2,92.85714286,0,28,0,10,1,3.571428571,0.035714286
West Germany (FRG),1975,1,35,31,4,88.57142857,0,35,0,12,1,2.857142857,0.028571429
West Germany (FRG),1976,4,50,43,7,86,0,50,0,36,3,6,0.08
West Germany (FRG),1977,6,40,33,7,82.5,0,40,0,2,4,10,0.15
West Germany (FRG),1978,0,19,17,2,89.47368421,0,19,0,3,0,0,0
West Germany (FRG),1979,0,17,14,3,82.35294118,0,17,0,10,0,0,0
West Germany (FRG),1980,17,20,18,2,90,0,20,0,218,4,20,0.85
West Germany (FRG),1981,2,31,25,6,80.64516129,0,31,0,31,2,6.451612903,0.064516129
West Germany (FRG),1982,5,29,24,5,82.75862069,0,29,0,44,3,10.34482759,0.172413793
West Germany (FRG),1983,2,5,5,0,100,0,5,0,25,1,20,0.4
West Germany (FRG),1984,0,21,18,3,85.71428571,0,21,0,2,0,0,0
West Germany (FRG),1985,9,53,42,11,79.24528302,0,53,0,114,6,11.32075472,0.169811321
West Germany (FRG),1986,9,46,43,3,93.47826087,0,46,0,242,5,10.86956522,0.195652174
West Germany (FRG),1987,2,19,17,2,89.47368421,0,19,0,32,1,5.263157895,0.105263158
West Germany (FRG),1988,1,14,10,4,71.42857143,0,14,0,14,1,7.142857143,0.071428571
West Germany (FRG),1989,5,21,17,4,80.95238095,0,21,0,8,4,19.04761905,0.238095238
West Germany (FRG),1990,1,9,6,3,66.66666667,0,9,0,4,1,11.11111111,0.111111111
Western Europe,1970,79,50,42,8,84,0,50,0,10,16,32,1.58
Western Europe,1971,112,125,116,9,92.8,0,125,0,6,81,64.8,0.896
Western Europe,1972,405,376,339,37,90.15957447,0,376,0,282,296,78.72340426,1.07712766
Western Europe,1973,295,290,270,20,93.10344828,0,290,0,407,196,67.5862069,1.017241379
Western Europe,1974,408,317,297,20,93.69085174,0,317,0,601,194,61.19873817,1.287066246
Western Europe,1975,299,438,422,16,96.34703196,0,438,0,195,220,50.2283105,0.682648402
Western Europe,1976,323,578,551,27,95.32871972,0,578,0,120,229,39.61937716,0.558823529
Western Europe,1977,195,771,702,69,91.05058366,0,771,0,201,155,20.10376135,0.252918288
Western Europe,1978,231,729,666,63,91.35802469,0,729,0,334,143,19.61591221,0.316872428
Western Europe,1979,301,1020,911,109,89.31372549,0,1020,0,689,223,21.8627451,0.295098039
Western Europe,1980,390,595,525,70,88.23529412,0,595,0,883,216,36.30252101,0.655462185
Western Europe,1981,177,484,408,76,84.29752066,0,484,0,590,147,30.37190083,0.365702479
Western Europe,1982,178,402,359,43,89.30348259,0,402,0,459,121,30.09950249,0.44278607
Western Europe,1983,163,475,409,66,86.10526316,0,475,0,488,119,25.05263158,0.343157895
Western Europe,1984,175,541,481,60,88.90942699,0,541,0,611,125,23.10536044,0.323475046
Western Europe,1985,261,466,425,41,91.20171674,0,466,0,985,118,25.32188841,0.560085837
Western Europe,1986,165,455,402,53,88.35164835,0,455,0,846,108,23.73626374,0.362637363
Western Europe,1987,194,416,335,81,80.52884615,0,416,0,431,116,27.88461538,0.466346154
Western Europe,1988,437,489,413,76,84.45807771,0,489,0,590,112,22.90388548,0.893660532
Western Europe,1989,119,444,335,109,75.45045045,0,444,0,234,88,19.81981982,0.268018018
Western Europe,1990,120,390,304,86,77.94871795,0,390,0,292,88,22.56410256,0.307692308
Western Europe,1991,170,696,570,126,81.89655172,0,696,0,473,119,17.09770115,0.244252874
Western Europe,1992,179,769,669,100,86.99609883,0,769,0,838,128,16.6449935,0.232769831
Western Europe,1994,105,584,483,101,82.70547945,0,584,0,365,84,14.38356164,0.179794521
Western Europe,1995,68,337,308,29,91.39465875,0,337,0,322,46,13.64985163,0.201780415
Western Europe,1996,43,476,400,76,84.03361345,0,476,0,589,37,7.773109244,0.090336134
Western Europe,1997,40,349,288,61,82.52148997,0,349,0,95,36,10.31518625,0.114613181
Western Europe,1998,54,141,117,24,82.9787234,0,141,0,283,22,15.60283688,0.382978723
Western Europe,1999,12,236,190,46,80.50847458,0,236,0,221,9,3.813559322,0.050847458
Western Europe,2000,42,253,211,42,83.39920949,0,253,0,155,29,11.46245059,0.166007905
Western Europe,2001,40,234,182,52,77.77777778,1,233,0.427350427,259,24,10.25641026,0.170940171
Western Europe,2002,9,120,100,20,83.33333333,0,120,0,94,8,6.666666667,0.075
Western Europe,2003,5,121,89,32,73.55371901,0,121,0,130,3,2.479338843,0.041322314
Western Europe,2004,196,59,50,9,84.74576271,1,58,1.694915254,1853,8,13.55932203,3.322033898
Western Europe,2005,60,104,98,6,94.23076923,4,100,3.846153846,942,8,7.692307692,0.576923077
Western Europe,2006,6,98,84,14,85.71428571,0,98,0,31,5,5.102040816,0.06122449
Western Europe,2007,17,72,64,8,88.88888889,2,70,2.777777778,44,7,9.722222222,0.236111111
Western Europe,2008,3,163,140,23,85.88957055,0,163,0,76,3,1.840490798,0.018404908
Western Europe,2009,15,182,173,9,95.05494505,0,182,0,104,7,3.846153846,0.082417582
Western Europe,2010,5,133,89,44,66.91729323,1,132,0.751879699,42,5,3.759398496,0.037593985
Western Europe,2011,83,95,56,39,58.94736842,0,95,0,96,6,6.315789474,0.873684211
Western Europe,2012,11,193,127,66,65.80310881,0,193,0,15,6,3.10880829,0.056994819
Western Europe,2013,7,261,152,109,58.23754789,0,261,0,85,6,2.298850575,0.026819923
Western Europe,2014,5,215,142,73,66.04651163,1,214,0.465116279,31,2,0.930232558,0.023255814
Western Europe,2015,171,333,243,90,72.97297297,5,328,1.501501502,526,21,6.306306306,0.513513514
Western Europe,2016,238,273,206,67,75.45787546,2,271,0.732600733,900,30,10.98901099,0.871794872
Western Europe,2017,83,291,218,73,74.91408935,6,285,2.06185567,509,19,6.529209622,0.285223368
Western Sahara,1978,0,1,1,0,100,0,1,0,0,0,0,0
Western Sahara,1984,0,1,1,0,100,0,1,0,0,0,0,0
Western Sahara,1986,1,1,1,0,100,0,1,0,0,1,100,1
Western Sahara,1992,0,1,1,0,100,0,1,0,1,0,0,0
Western Sahara,2007,0,1,1,0,100,0,1,0,3,0,0,0
World,1970,174,651,549,102,84.33179724,0,651,0,212,65,9.984639017,0.267281106
World,1971,173,471,420,51,89.17197452,0,471,0,82,109,23.14225053,0.367303609
World,1972,566,568,452,116,79.57746479,0,568,0,409,322,56.69014085,0.996478873
World,1973,370,473,433,40,91.54334038,0,473,0,495,244,51.58562368,0.782241015
World,1974,539,581,545,36,93.80378657,0,581,0,865,240,41.3080895,0.927710843
World,1975,617,740,705,35,95.27027027,0,740,0,617,270,36.48648649,0.833783784
World,1976,674,923,861,62,93.28277356,0,923,0,756,312,33.8028169,0.730227519
World,1977,456,1319,1191,128,90.29567854,0,1319,0,518,248,18.80212282,0.345716452
World,1978,1459,1526,1411,115,92.46395806,0,1526,0,1600,373,24.4429882,0.956094364
World,1979,2100,2662,2408,254,90.45830203,0,2662,0,2506,835,31.36739294,0.788880541
World,1980,4400,2662,2387,275,89.66942149,0,2662,0,3645,1112,41.77310293,1.652892562
World,1981,4851,2586,2354,232,91.02861562,1,2585,0.03866976,3337,926,35.80819799,1.87587007
World,1982,5136,2544,2373,171,93.27830189,1,2543,0.039308176,3342,827,32.50786164,2.018867925
World,1983,9444,2870,2660,210,92.68292683,5,2865,0.174216028,4047,1008,35.12195122,3.290592334
World,1984,10450,3495,3282,213,93.9055794,2,3493,0.057224607,5291,1104,31.58798283,2.989985694
World,1985,7094,2915,2727,188,93.55060034,16,2899,0.548885077,5130,940,32.24699828,2.433619211
World,1986,4976,2860,2670,190,93.35664336,3,2857,0.104895105,5814,1000,34.96503497,1.73986014
World,1987,6482,3183,2933,250,92.14577443,3,3180,0.094250707,5775,1164,36.56927427,2.036443607
World,1988,7208,3721,3440,281,92.4482666,2,3719,0.053748992,6960,1636,43.96667562,1.937113679
World,1989,8152,4324,4008,316,92.6919519,3,4321,0.069380204,5539,1834,42.41443108,1.885291397
World,1990,7148,3887,3583,304,92.1790584,2,3885,0.051453563,6128,1564,40.23668639,1.838950347
World,1991,8429,4683,4299,384,91.80012812,3,4680,0.064061499,7591,1660,35.4473628,1.799914585
World,1992,9742,5071,4560,511,89.92309209,2,5069,0.039439953,9915,2170,42.79234865,1.921120095
World,1994,7690,3456,3069,387,88.80208333,11,3445,0.318287037,7569,1443,41.75347222,2.225115741
World,1995,6103,3081,2794,287,90.68484258,22,3059,0.714053879,14292,1390,45.11522233,1.980850373
World,1996,6966,3058,2770,288,90.58207979,15,3043,0.490516678,10795,1296,42.38064094,2.277959451
World,1997,10924,3197,2966,231,92.77447607,11,3186,0.344072568,9072,1590,49.73412574,3.416953394
World,1998,4688,934,859,75,91.97002141,21,913,2.248394004,8183,450,48.17987152,5.019271949
World,1999,3393,1395,1237,158,88.67383513,28,1367,2.007168459,5341,570,40.86021505,2.432258065
World,2000,4403,1814,1637,177,90.24255788,37,1777,2.03969129,5869,789,43.49503859,2.427232635
World,2001,7729,1906,1689,217,88.61490031,54,1852,2.833158447,22774,902,47.32423924,4.055089192
World,2002,4805,1333,1213,120,90.99774944,78,1255,5.851462866,7162,702,52.66316579,3.604651163
World,2003,3317,1278,1149,129,89.90610329,89,1189,6.96400626,7384,643,50.31298905,2.595461659
World,2004,5743,1166,1080,86,92.62435678,122,1044,10.46312178,12022,744,63.80789022,4.925385935
World,2005,6331,2017,1910,107,94.69509172,213,1804,10.56023798,12784,1255,62.22112048,3.13882003
World,2006,9380,2758,2660,98,96.44670051,183,2575,6.63524293,15550,1625,58.91950689,3.401015228
World,2007,12824,3242,3123,119,96.32942628,374,2868,11.53608883,22524,2028,62.55397903,3.955582973
World,2008,9157,4805,4402,403,91.61290323,247,4558,5.140478668,18998,2224,46.28511967,1.905723205
World,2009,9273,4721,4430,291,93.83605168,183,4538,3.876297395,19138,2169,45.94365601,1.964202499
World,2010,7827,4826,4385,441,90.86199751,175,4651,3.626191463,15947,2169,44.94405305,1.621840033
World,2011,8246,5076,4606,470,90.74074074,208,4868,4.097714736,14659,2528,49.80299448,1.624507486
World,2012,15497,8522,7600,922,89.18094344,402,8120,4.717202535,25445,4423,51.90096222,1.818469843
World,2013,22273,12036,10484,1552,87.10535061,622,11414,5.167829844,37688,6078,50.49850449,1.850531738
World,2014,44490,16903,15015,1888,88.83038514,744,16159,4.401585517,41128,8192,48.46476957,2.632077146
World,2015,38853,14965,12676,2289,84.70431006,922,14043,6.161042432,44043,7645,51.08586702,2.596257935
World,2016,34871,13587,10975,2612,80.77574152,985,12602,7.249576801,40001,7080,52.10863325,2.566497387
World,2017,26445,10900,8652,2248,79.37614679,844,10056,7.743119266,24927,5331,48.90825688,2.426146789
Yemen,1991,1,5,4,1,80,0,5,0,2,1,20,0.2
Yemen,1992,20,24,19,5,79.16666667,0,24,0,21,7,29.16666667,0.833333333
Yemen,1994,14,19,15,4,78.94736842,0,19,0,2,7,36.84210526,0.736842105
Yemen,1995,4,8,6,2,75,0,8,0,12,2,25,0.5
Yemen,1996,3,8,8,0,100,0,8,0,4,1,12.5,0.375
Yemen,1997,11,19,18,1,94.73684211,0,19,0,8,7,36.84210526,0.578947368
Yemen,1998,8,7,7,0,100,0,7,0,3,3,42.85714286,1.142857143
Yemen,1999,11,17,17,0,100,0,17,0,45,6,35.29411765,0.647058824
Yemen,2000,19,10,9,1,90,2,8,20,40,1,10,1.9
Yemen,2001,2,7,7,0,100,0,7,0,3,1,14.28571429,0.285714286
Yemen,2002,4,7,7,0,100,0,7,0,6,2,28.57142857,0.571428571
Yemen,2003,16,7,7,0,100,0,7,0,9,5,71.42857143,2.285714286
Yemen,2005,12,7,5,2,71.42857143,0,7,0,7,1,14.28571429,1.714285714
Yemen,2006,14,5,5,0,100,1,4,20,9,3,60,2.8
Yemen,2007,24,7,7,0,100,1,6,14.28571429,46,4,57.14285714,3.428571429
Yemen,2008,74,22,22,0,100,2,20,9.090909091,177,14,63.63636364,3.363636364
Yemen,2009,47,23,21,2,91.30434783,2,21,8.695652174,29,11,47.82608696,2.043478261
Yemen,2010,345,112,99,13,88.39285714,7,105,6.25,233,70,62.5,3.080357143
Yemen,2011,461,118,106,12,89.83050847,7,111,5.93220339,415,83,70.33898305,3.906779661
Yemen,2012,1056,312,268,44,85.8974359,36,276,11.53846154,925,165,52.88461538,3.384615385
Yemen,2013,624,425,351,74,82.58823529,20,405,4.705882353,899,163,38.35294118,1.468235294
Yemen,2014,1353,763,659,104,86.36959371,37,726,4.849279161,1305,339,44.42988204,1.773263434
Yemen,2015,2374,664,581,83,87.5,37,627,5.572289157,3065,345,51.95783133,3.575301205
Yemen,2016,1517,525,407,118,77.52380952,53,472,10.0952381,1341,254,48.38095238,2.88952381
Yemen,2017,762,226,182,44,80.53097345,15,211,6.637168142,722,136,60.17699115,3.371681416
Yugoslavia,1973,1,1,1,0,100,0,1,0,7,1,100,1
Yugoslavia,1974,0,1,1,0,100,0,1,0,0,0,0,0
Yugoslavia,1977,1,1,1,0,100,0,1,0,7,1,100,1
Yugoslavia,1980,0,1,1,0,100,0,1,0,2,0,0,0
Yugoslavia,1981,0,2,2,0,100,0,2,0,4,0,0,0
Yugoslavia,1983,2,1,1,0,100,0,1,0,4,1,100,2
Yugoslavia,1984,2,1,0,1,0,0,1,0,1,1,100,2
Yugoslavia,1989,0,3,3,0,100,0,3,0,0,0,0,0
Yugoslavia,1990,0,5,4,1,80,0,5,0,0,0,0,0
Yugoslavia,1991,6,11,10,1,90.90909091,0,11,0,7,5,45.45454545,0.545454545
Yugoslavia,1992,3,12,12,0,100,0,12,0,43,2,16.66666667,0.25
Yugoslavia,1994,0,1,1,0,100,0,1,0,0,0,0,0
Yugoslavia,1995,2,3,2,1,66.66666667,0,3,0,7,1,33.33333333,0.666666667
Yugoslavia,1996,9,16,16,0,100,0,16,0,9,7,43.75,0.5625
Yugoslavia,1997,9,38,37,1,97.36842105,0,38,0,28,8,21.05263158,0.236842105
Yugoslavia,1998,57,46,36,10,78.26086957,0,46,0,34,15,32.60869565,1.239130435
Yugoslavia,1999,14,23,21,2,91.30434783,0,23,0,108,8,34.7826087,0.608695652
Yugoslavia,2000,5,14,13,1,92.85714286,0,14,0,9,5,35.71428571,0.357142857
Yugoslavia,2001,8,20,14,6,70,0,20,0,11,5,25,0.4
Yugoslavia,2002,0,3,3,0,100,0,3,0,0,0,0,0
Zaire,1972,0,3,0,3,0,0,3,0,0,0,0,0
Zaire,1973,0,1,1,0,100,0,1,0,2,0,0,0
Zaire,1977,1,1,1,0,100,0,1,0,0,1,100,1
Zaire,1984,2,3,2,1,66.66666667,0,3,0,0,1,33.33333333,0.666666667
Zaire,1988,28,1,1,0,100,0,1,0,0,1,100,28
Zaire,1991,3,6,5,1,83.33333333,0,6,0,18,1,16.66666667,0.5
Zaire,1992,10,5,5,0,100,0,5,0,56,3,60,2
Zaire,1994,1,6,6,0,100,0,6,0,7,1,16.66666667,0.166666667
Zaire,1995,43,6,6,0,100,0,6,0,33,5,83.33333333,7.166666667
Zaire,1996,223,13,13,0,100,0,13,0,92,12,92.30769231,17.15384615
Zaire,1997,13,5,5,0,100,0,5,0,3,3,60,2.6
Zambia,1971,1,1,1,0,100,0,1,0,0,1,100,1
Zambia,1973,2,1,1,0,100,0,1,0,0,1,100,2
Zambia,1975,1,1,1,0,100,0,1,0,0,1,100,1
Zambia,1977,1,1,1,0,100,0,1,0,0,1,100,1
Zambia,1978,0,3,3,0,100,0,3,0,0,0,0,0
Zambia,1979,0,1,1,0,100,0,1,0,0,0,0,0
Zambia,1981,0,1,0,1,0,0,1,0,0,0,0,0
Zambia,1985,0,1,1,0,100,0,1,0,0,0,0,0
Zambia,1986,2,1,1,0,100,0,1,0,0,1,100,2
Zambia,1987,0,1,1,0,100,0,1,0,0,0,0,0
Zambia,1988,9,5,5,0,100,0,5,0,18,4,80,1.8
Zambia,1989,33,18,18,0,100,0,18,0,11,12,66.66666667,1.833333333
Zambia,1990,20,4,4,0,100,0,4,0,22,3,75,5
Zambia,1995,0,1,1,0,100,0,1,0,0,0,0,0
Zambia,1996,0,4,3,1,75,0,4,0,8,0,0,0
Zambia,1999,1,7,6,1,85.71428571,0,7,0,1,1,14.28571429,0.142857143
Zambia,2000,0,8,8,0,100,0,8,0,2,0,0,0
Zambia,2002,0,1,1,0,100,0,1,0,0,0,0,0
Zambia,2017,0,2,1,1,50,0,2,0,0,0,0,0
Zimbabwe,1980,13,14,13,1,92.85714286,0,14,0,75,7,50,0.928571429
Zimbabwe,1981,13,9,8,1,88.88888889,0,9,0,0,8,88.88888889,1.444444444
Zimbabwe,1982,22,12,12,0,100,0,12,0,0,6,50,1.833333333
Zimbabwe,1983,11,6,6,0,100,0,6,0,3,5,83.33333333,1.833333333
Zimbabwe,1984,4,3,3,0,100,0,3,0,0,3,100,1.333333333
Zimbabwe,1985,5,1,1,0,100,0,1,0,0,1,100,5
Zimbabwe,1986,1,1,1,0,100,0,1,0,0,1,100,1
Zimbabwe,1987,35,11,11,0,100,0,11,0,19,8,72.72727273,3.181818182
Zimbabwe,1988,2,1,1,0,100,0,1,0,3,1,100,2
Zimbabwe,1989,21,3,3,0,100,0,3,0,9,3,100,7
Zimbabwe,1990,9,6,5,1,83.33333333,0,6,0,14,1,16.66666667,1.5
Zimbabwe,1991,0,1,1,0,100,0,1,0,0,0,0,0
Zimbabwe,1992,0,1,1,0,100,0,1,0,0,0,0,0
Zimbabwe,1994,0,1,1,0,100,0,1,0,25,0,0,0
Zimbabwe,1995,0,2,0,2,0,0,2,0,1,0,0,0
Zimbabwe,2000,0,1,1,0,100,0,1,0,0,0,0,0
Zimbabwe,2001,1,3,3,0,100,0,3,0,0,1,33.33333333,0.333333333
Zimbabwe,2002,8,8,8,0,100,0,8,0,49,2,25,1
Zimbabwe,2003,0,1,1,0,100,0,1,0,8,0,0,0
Zimbabwe,2006,0,1,1,0,100,0,1,0,5,0,0,0
Zimbabwe,2007,0,1,1,0,100,0,1,0,0,0,0,0
Zimbabwe,2008,7,5,5,0,100,0,5,0,8,1,20,1.4
Zimbabwe,2010,1,1,1,0,100,0,1,0,1,1,100,1
Zimbabwe,2011,0,1,1,0,100,0,1,0,0,0,0,0
Zimbabwe,2013,1,3,3,0,100,0,3,0,1,1,33.33333333,0.333333333
Zimbabwe,2014,0,1,1,0,100,0,1,0,0,0,0,0
Zimbabwe,2017,0,3,3,0,100,0,3,0,1,0,0,0
